County FIPS,Test Date,POP_ESTIMATE_2018,sdi_score,New Positives,Cumulative Number of Positives,Total Number of Tests Performed,Cumulative Number of Tests Performed,Rolling Avg New Cases,Per Capita Rate,sdi_quartile,sdi_quartile_label
36001,2020-03-02,307117,36,0,0,0,0,0.0,0.0,"(24.0, 37.5]",Q2
36001,2020-03-03,307117,36,0,0,0,0,0.0,0.0,"(24.0, 37.5]",Q2
36001,2020-03-04,307117,36,0,0,0,0,0.0,0.0,"(24.0, 37.5]",Q2
36001,2020-03-05,307117,36,0,0,3,3,0.0,0.0,"(24.0, 37.5]",Q2
36001,2020-03-06,307117,36,0,0,0,3,0.0,0.0,"(24.0, 37.5]",Q2
36001,2020-03-07,307117,36,0,0,5,8,0.0,0.0,"(24.0, 37.5]",Q2
36001,2020-03-08,307117,36,0,0,2,10,0.0,0.0,"(24.0, 37.5]",Q2
36001,2020-03-09,307117,36,0,0,3,13,0.0,0.0,"(24.0, 37.5]",Q2
36001,2020-03-10,307117,36,0,0,2,15,0.0,0.0,"(24.0, 37.5]",Q2
36001,2020-03-11,307117,36,0,0,13,28,0.0,0.0,"(24.0, 37.5]",Q2
36001,2020-03-12,307117,36,1,1,11,39,0.14285714285714285,0.04651554386671622,"(24.0, 37.5]",Q2
36001,2020-03-13,307117,36,2,3,26,65,0.42857142857142855,0.13954663160014866,"(24.0, 37.5]",Q2
36001,2020-03-14,307117,36,3,6,108,173,0.8571428571428571,0.2790932632002973,"(24.0, 37.5]",Q2
36001,2020-03-15,307117,36,6,12,108,281,1.7142857142857142,0.5581865264005946,"(24.0, 37.5]",Q2
36001,2020-03-16,307117,36,11,23,140,421,3.2857142857142856,1.069857508934473,"(24.0, 37.5]",Q2
36001,2020-03-17,307117,36,13,36,267,688,5.142857142857143,1.674559579201784,"(24.0, 37.5]",Q2
36001,2020-03-18,307117,36,7,43,331,1019,6.142857142857143,2.0001683862687973,"(24.0, 37.5]",Q2
36001,2020-03-19,307117,36,18,61,450,1469,8.571428571428571,2.7909326320029733,"(24.0, 37.5]",Q2
36001,2020-03-20,307117,36,27,88,499,1968,12.142857142857142,3.9538212286708787,"(24.0, 37.5]",Q2
36001,2020-03-21,307117,36,35,123,577,2545,16.714285714285715,5.442318632405798,"(24.0, 37.5]",Q2
36001,2020-03-22,307117,36,4,127,197,2742,16.428571428571427,5.3492875446723644,"(24.0, 37.5]",Q2
36001,2020-03-23,307117,36,19,146,144,2886,17.571428571428573,5.721411895606096,"(24.0, 37.5]",Q2
36001,2020-03-24,307117,36,6,152,198,3084,16.571428571428573,5.395803088539083,"(24.0, 37.5]",Q2
36001,2020-03-25,307117,36,19,171,93,3177,18.285714285714285,5.953989614939676,"(24.0, 37.5]",Q2
36001,2020-03-26,307117,36,16,187,112,3289,18.0,5.860958527206244,"(24.0, 37.5]",Q2
36001,2020-03-27,307117,36,8,195,101,3390,15.285714285714286,4.977163193738636,"(24.0, 37.5]",Q2
36001,2020-03-28,307117,36,10,205,73,3463,11.714285714285714,3.81427459707073,"(24.0, 37.5]",Q2
36001,2020-03-29,307117,36,12,217,61,3524,12.857142857142858,4.18639894800446,"(24.0, 37.5]",Q2
36001,2020-03-30,307117,36,9,226,72,3596,11.428571428571429,3.721243509337298,"(24.0, 37.5]",Q2
36001,2020-03-31,307117,36,14,240,108,3704,12.571428571428571,4.0933678602710275,"(24.0, 37.5]",Q2
36001,2020-04-01,307117,36,13,253,106,3810,11.714285714285714,3.81427459707073,"(24.0, 37.5]",Q2
36001,2020-04-02,307117,36,14,267,105,3915,11.428571428571429,3.721243509337298,"(24.0, 37.5]",Q2
36001,2020-04-03,307117,36,26,293,123,4038,14.0,4.55852329893819,"(24.0, 37.5]",Q2
36001,2020-04-04,307117,36,12,305,117,4155,14.285714285714286,4.651554386671622,"(24.0, 37.5]",Q2
36001,2020-04-05,307117,36,14,319,89,4244,14.571428571428571,4.744585474405055,"(24.0, 37.5]",Q2
36001,2020-04-06,307117,36,14,333,86,4330,15.285714285714286,4.977163193738636,"(24.0, 37.5]",Q2
36001,2020-04-07,307117,36,9,342,74,4404,14.571428571428571,4.744585474405055,"(24.0, 37.5]",Q2
36001,2020-04-08,307117,36,37,379,229,4633,18.0,5.860958527206244,"(24.0, 37.5]",Q2
36001,2020-04-09,307117,36,47,426,332,4965,22.714285714285715,7.3959714748078795,"(24.0, 37.5]",Q2
36001,2020-04-10,307117,36,20,446,159,5124,21.857142857142858,7.116878211607582,"(24.0, 37.5]",Q2
36001,2020-04-11,307117,36,32,478,223,5347,24.714285714285715,8.047189088941906,"(24.0, 37.5]",Q2
36001,2020-04-12,307117,36,21,499,193,5540,25.714285714285715,8.37279789600892,"(24.0, 37.5]",Q2
36001,2020-04-13,307117,36,36,535,216,5756,28.857142857142858,9.396139861076676,"(24.0, 37.5]",Q2
36001,2020-04-14,307117,36,13,548,106,5862,29.428571428571427,9.582202036543542,"(24.0, 37.5]",Q2
36001,2020-04-15,307117,36,33,581,301,6163,28.857142857142858,9.396139861076676,"(24.0, 37.5]",Q2
36001,2020-04-16,307117,36,38,619,273,6436,27.571428571428573,8.977499966276232,"(24.0, 37.5]",Q2
36001,2020-04-17,307117,36,29,648,291,6727,28.857142857142858,9.396139861076676,"(24.0, 37.5]",Q2
36001,2020-04-18,307117,36,34,682,305,7032,29.142857142857142,9.48917094881011,"(24.0, 37.5]",Q2
36001,2020-04-19,307117,36,5,687,103,7135,26.857142857142858,8.74492224694265,"(24.0, 37.5]",Q2
36001,2020-04-20,307117,36,17,704,164,7299,24.142857142857142,7.861126913475041,"(24.0, 37.5]",Q2
36001,2020-04-21,307117,36,33,737,236,7535,27.0,8.791437790809365,"(24.0, 37.5]",Q2
36001,2020-04-22,307117,36,21,758,178,7713,25.285714285714285,8.233251264408771,"(24.0, 37.5]",Q2
36001,2020-04-23,307117,36,47,805,319,8032,26.571428571428573,8.651891159209217,"(24.0, 37.5]",Q2
36001,2020-04-24,307117,36,94,899,626,8658,35.857142857142854,11.675401510545772,"(24.0, 37.5]",Q2
36001,2020-04-25,307117,36,49,948,402,9060,38.0,12.373134668546514,"(24.0, 37.5]",Q2
36001,2020-04-26,307117,36,31,979,263,9323,41.714285714285715,13.582538809081136,"(24.0, 37.5]",Q2
36001,2020-04-27,307117,36,30,1009,197,9520,43.57142857142857,14.187240879348447,"(24.0, 37.5]",Q2
36001,2020-04-28,307117,36,58,1067,351,9871,47.142857142857146,15.350129476016354,"(24.0, 37.5]",Q2
36001,2020-04-29,307117,36,98,1165,439,10310,58.142857142857146,18.931826353753504,"(24.0, 37.5]",Q2
36001,2020-04-30,307117,36,39,1204,378,10688,57.0,18.559702002819773,"(24.0, 37.5]",Q2
36001,2020-05-01,307117,36,34,1238,434,11122,48.42857142857143,15.7687693708168,"(24.0, 37.5]",Q2
36001,2020-05-02,307117,36,20,1258,441,11563,44.285714285714285,14.41981859868203,"(24.0, 37.5]",Q2
36001,2020-05-03,307117,36,29,1287,391,11954,44.0,14.326787510948597,"(24.0, 37.5]",Q2
36001,2020-05-04,307117,36,7,1294,130,12084,40.714285714285715,13.256930002014125,"(24.0, 37.5]",Q2
36001,2020-05-05,307117,36,27,1321,367,12451,36.285714285714285,11.81494814214592,"(24.0, 37.5]",Q2
36001,2020-05-06,307117,36,27,1348,407,12858,26.142857142857142,8.512344527609068,"(24.0, 37.5]",Q2
36001,2020-05-07,307117,36,36,1384,385,13243,25.714285714285715,8.37279789600892,"(24.0, 37.5]",Q2
36001,2020-05-08,307117,36,32,1416,488,13731,25.428571428571427,8.279766808275486,"(24.0, 37.5]",Q2
36001,2020-05-09,307117,36,16,1432,455,14186,24.857142857142858,8.093704632808622,"(24.0, 37.5]",Q2
36001,2020-05-10,307117,36,24,1456,384,14570,24.142857142857142,7.861126913475041,"(24.0, 37.5]",Q2
36001,2020-05-11,307117,36,23,1479,341,14911,26.428571428571427,8.605375615342501,"(24.0, 37.5]",Q2
36001,2020-05-12,307117,36,15,1494,335,15246,24.714285714285715,8.047189088941906,"(24.0, 37.5]",Q2
36001,2020-05-13,307117,36,15,1509,546,15792,23.0,7.4890025625413115,"(24.0, 37.5]",Q2
36001,2020-05-14,307117,36,29,1538,541,16333,22.0,7.163393755474298,"(24.0, 37.5]",Q2
36001,2020-05-15,307117,36,34,1572,482,16815,22.285714285714285,7.256424843207729,"(24.0, 37.5]",Q2
36001,2020-05-16,307117,36,7,1579,411,17226,21.0,6.837784948407284,"(24.0, 37.5]",Q2
36001,2020-05-17,307117,36,31,1610,342,17568,22.0,7.163393755474298,"(24.0, 37.5]",Q2
36001,2020-05-18,307117,36,45,1655,398,17966,25.142857142857142,8.186735720542055,"(24.0, 37.5]",Q2
36001,2020-05-19,307117,36,27,1682,697,18663,26.857142857142858,8.74492224694265,"(24.0, 37.5]",Q2
36001,2020-05-20,307117,36,18,1700,650,19313,27.285714285714285,8.884468878542798,"(24.0, 37.5]",Q2
36001,2020-05-21,307117,36,56,1756,920,20233,31.142857142857142,10.140388562944135,"(24.0, 37.5]",Q2
36001,2020-05-22,307117,36,14,1770,655,20888,28.285714285714285,9.21007768560981,"(24.0, 37.5]",Q2
36001,2020-05-23,307117,36,12,1782,438,21326,29.0,9.442655404943393,"(24.0, 37.5]",Q2
36001,2020-05-24,307117,36,9,1791,378,21704,25.857142857142858,8.419313439875637,"(24.0, 37.5]",Q2
36001,2020-05-25,307117,36,2,1793,328,22032,19.714285714285715,6.419145053606838,"(24.0, 37.5]",Q2
36001,2020-05-26,307117,36,3,1796,369,22401,16.285714285714285,5.302772000805649,"(24.0, 37.5]",Q2
36001,2020-05-27,307117,36,18,1814,666,23067,16.285714285714285,5.302772000805649,"(24.0, 37.5]",Q2
36001,2020-05-28,307117,36,20,1834,416,23483,11.142857142857142,3.6282124216038647,"(24.0, 37.5]",Q2
36001,2020-05-29,307117,36,9,1843,521,24004,10.428571428571429,3.395634702270284,"(24.0, 37.5]",Q2
36001,2020-05-30,307117,36,17,1860,760,24764,11.142857142857142,3.6282124216038647,"(24.0, 37.5]",Q2
36001,2020-05-31,307117,36,22,1882,537,25301,13.0,4.232914491871177,"(24.0, 37.5]",Q2
36001,2020-06-01,307117,36,18,1900,618,25919,15.285714285714286,4.977163193738636,"(24.0, 37.5]",Q2
36001,2020-06-02,307117,36,20,1920,1170,27089,17.714285714285715,5.767927439472812,"(24.0, 37.5]",Q2
36001,2020-06-03,307117,36,10,1930,817,27906,16.571428571428573,5.395803088539083,"(24.0, 37.5]",Q2
36001,2020-06-04,307117,36,11,1941,1179,29085,15.285714285714286,4.977163193738636,"(24.0, 37.5]",Q2
36001,2020-06-05,307117,36,12,1953,1164,30249,15.714285714285714,5.116709825338784,"(24.0, 37.5]",Q2
36001,2020-06-06,307117,36,8,1961,751,31000,14.428571428571429,4.698069930538338,"(24.0, 37.5]",Q2
36001,2020-06-07,307117,36,17,1978,1194,32194,13.714285714285714,4.465492211204757,"(24.0, 37.5]",Q2
36003,2020-03-02,46430,44,0,0,0,0,0.0,0.0,"(37.5, 52.0]",Q3
36003,2020-03-03,46430,44,0,0,0,0,0.0,0.0,"(37.5, 52.0]",Q3
36003,2020-03-04,46430,44,0,0,0,0,0.0,0.0,"(37.5, 52.0]",Q3
36003,2020-03-05,46430,44,0,0,0,0,0.0,0.0,"(37.5, 52.0]",Q3
36003,2020-03-06,46430,44,0,0,0,0,0.0,0.0,"(37.5, 52.0]",Q3
36003,2020-03-07,46430,44,0,0,0,0,0.0,0.0,"(37.5, 52.0]",Q3
36003,2020-03-08,46430,44,0,0,0,0,0.0,0.0,"(37.5, 52.0]",Q3
36003,2020-03-09,46430,44,0,0,0,0,0.0,0.0,"(37.5, 52.0]",Q3
36003,2020-03-10,46430,44,0,0,0,0,0.0,0.0,"(37.5, 52.0]",Q3
36003,2020-03-11,46430,44,0,0,4,4,0.0,0.0,"(37.5, 52.0]",Q3
36003,2020-03-12,46430,44,0,0,1,5,0.0,0.0,"(37.5, 52.0]",Q3
36003,2020-03-13,46430,44,0,0,0,5,0.0,0.0,"(37.5, 52.0]",Q3
36003,2020-03-14,46430,44,0,0,1,6,0.0,0.0,"(37.5, 52.0]",Q3
36003,2020-03-15,46430,44,2,2,5,11,0.2857142857142857,0.6153656810559675,"(37.5, 52.0]",Q3
36003,2020-03-16,46430,44,0,2,1,12,0.2857142857142857,0.6153656810559675,"(37.5, 52.0]",Q3
36003,2020-03-17,46430,44,0,2,0,12,0.2857142857142857,0.6153656810559675,"(37.5, 52.0]",Q3
36003,2020-03-18,46430,44,0,2,3,15,0.2857142857142857,0.6153656810559675,"(37.5, 52.0]",Q3
36003,2020-03-19,46430,44,0,2,2,17,0.2857142857142857,0.6153656810559675,"(37.5, 52.0]",Q3
36003,2020-03-20,46430,44,0,2,10,27,0.2857142857142857,0.6153656810559675,"(37.5, 52.0]",Q3
36003,2020-03-21,46430,44,0,2,10,37,0.2857142857142857,0.6153656810559675,"(37.5, 52.0]",Q3
36003,2020-03-22,46430,44,0,2,39,76,0.0,0.0,"(37.5, 52.0]",Q3
36003,2020-03-23,46430,44,0,2,2,78,0.0,0.0,"(37.5, 52.0]",Q3
36003,2020-03-24,46430,44,0,2,5,83,0.0,0.0,"(37.5, 52.0]",Q3
36003,2020-03-25,46430,44,0,2,6,89,0.0,0.0,"(37.5, 52.0]",Q3
36003,2020-03-26,46430,44,0,2,9,98,0.0,0.0,"(37.5, 52.0]",Q3
36003,2020-03-27,46430,44,0,2,4,102,0.0,0.0,"(37.5, 52.0]",Q3
36003,2020-03-28,46430,44,4,6,12,114,0.5714285714285714,1.230731362111935,"(37.5, 52.0]",Q3
36003,2020-03-29,46430,44,1,7,7,121,0.7142857142857143,1.5384142026399186,"(37.5, 52.0]",Q3
36003,2020-03-30,46430,44,0,7,4,125,0.7142857142857143,1.5384142026399186,"(37.5, 52.0]",Q3
36003,2020-03-31,46430,44,2,9,10,135,1.0,2.1537798836958864,"(37.5, 52.0]",Q3
36003,2020-04-01,46430,44,3,12,14,149,1.4285714285714286,3.076828405279837,"(37.5, 52.0]",Q3
36003,2020-04-02,46430,44,2,14,18,167,1.7142857142857142,3.692194086335805,"(37.5, 52.0]",Q3
36003,2020-04-03,46430,44,2,16,13,180,2.0,4.307559767391773,"(37.5, 52.0]",Q3
36003,2020-04-04,46430,44,0,16,8,188,1.4285714285714286,3.076828405279837,"(37.5, 52.0]",Q3
36003,2020-04-05,46430,44,1,17,8,196,1.4285714285714286,3.076828405279837,"(37.5, 52.0]",Q3
36003,2020-04-06,46430,44,0,17,3,199,1.4285714285714286,3.076828405279837,"(37.5, 52.0]",Q3
36003,2020-04-07,46430,44,4,21,16,215,1.7142857142857142,3.692194086335805,"(37.5, 52.0]",Q3
36003,2020-04-08,46430,44,1,22,12,227,1.4285714285714286,3.076828405279837,"(37.5, 52.0]",Q3
36003,2020-04-09,46430,44,4,26,21,248,1.7142857142857142,3.692194086335805,"(37.5, 52.0]",Q3
36003,2020-04-10,46430,44,0,26,16,264,1.4285714285714286,3.076828405279837,"(37.5, 52.0]",Q3
36003,2020-04-11,46430,44,0,26,11,275,1.4285714285714286,3.076828405279837,"(37.5, 52.0]",Q3
36003,2020-04-12,46430,44,0,26,5,280,1.2857142857142858,2.7691455647518537,"(37.5, 52.0]",Q3
36003,2020-04-13,46430,44,2,28,14,294,1.5714285714285714,3.3845112458078215,"(37.5, 52.0]",Q3
36003,2020-04-14,46430,44,0,28,10,304,1.0,2.1537798836958864,"(37.5, 52.0]",Q3
36003,2020-04-15,46430,44,0,28,8,312,0.8571428571428571,1.8460970431679025,"(37.5, 52.0]",Q3
36003,2020-04-16,46430,44,1,29,21,333,0.42857142857142855,0.9230485215839512,"(37.5, 52.0]",Q3
36003,2020-04-17,46430,44,1,30,15,348,0.5714285714285714,1.230731362111935,"(37.5, 52.0]",Q3
36003,2020-04-18,46430,44,0,30,7,355,0.5714285714285714,1.230731362111935,"(37.5, 52.0]",Q3
36003,2020-04-19,46430,44,0,30,5,360,0.5714285714285714,1.230731362111935,"(37.5, 52.0]",Q3
36003,2020-04-20,46430,44,0,30,9,369,0.2857142857142857,0.6153656810559675,"(37.5, 52.0]",Q3
36003,2020-04-21,46430,44,0,30,10,379,0.2857142857142857,0.6153656810559675,"(37.5, 52.0]",Q3
36003,2020-04-22,46430,44,0,30,14,393,0.2857142857142857,0.6153656810559675,"(37.5, 52.0]",Q3
36003,2020-04-23,46430,44,1,31,10,403,0.2857142857142857,0.6153656810559675,"(37.5, 52.0]",Q3
36003,2020-04-24,46430,44,4,35,61,464,0.7142857142857143,1.5384142026399186,"(37.5, 52.0]",Q3
36003,2020-04-25,46430,44,0,35,12,476,0.7142857142857143,1.5384142026399186,"(37.5, 52.0]",Q3
36003,2020-04-26,46430,44,0,35,9,485,0.7142857142857143,1.5384142026399186,"(37.5, 52.0]",Q3
36003,2020-04-27,46430,44,0,35,14,499,0.7142857142857143,1.5384142026399186,"(37.5, 52.0]",Q3
36003,2020-04-28,46430,44,0,35,26,525,0.7142857142857143,1.5384142026399186,"(37.5, 52.0]",Q3
36003,2020-04-29,46430,44,0,35,18,543,0.7142857142857143,1.5384142026399186,"(37.5, 52.0]",Q3
36003,2020-04-30,46430,44,0,35,20,563,0.5714285714285714,1.230731362111935,"(37.5, 52.0]",Q3
36003,2020-05-01,46430,44,0,35,11,574,0.0,0.0,"(37.5, 52.0]",Q3
36003,2020-05-02,46430,44,0,35,18,592,0.0,0.0,"(37.5, 52.0]",Q3
36003,2020-05-03,46430,44,0,35,14,606,0.0,0.0,"(37.5, 52.0]",Q3
36003,2020-05-04,46430,44,0,35,31,637,0.0,0.0,"(37.5, 52.0]",Q3
36003,2020-05-05,46430,44,0,35,22,659,0.0,0.0,"(37.5, 52.0]",Q3
36003,2020-05-06,46430,44,0,35,40,699,0.0,0.0,"(37.5, 52.0]",Q3
36003,2020-05-07,46430,44,0,35,33,732,0.0,0.0,"(37.5, 52.0]",Q3
36003,2020-05-08,46430,44,0,35,18,750,0.0,0.0,"(37.5, 52.0]",Q3
36003,2020-05-09,46430,44,1,36,20,770,0.14285714285714285,0.3076828405279837,"(37.5, 52.0]",Q3
36003,2020-05-10,46430,44,2,38,35,805,0.42857142857142855,0.9230485215839512,"(37.5, 52.0]",Q3
36003,2020-05-11,46430,44,4,42,41,846,1.0,2.1537798836958864,"(37.5, 52.0]",Q3
36003,2020-05-12,46430,44,2,44,39,885,1.2857142857142858,2.7691455647518537,"(37.5, 52.0]",Q3
36003,2020-05-13,46430,44,0,44,53,938,1.2857142857142858,2.7691455647518537,"(37.5, 52.0]",Q3
36003,2020-05-14,46430,44,0,44,44,982,1.2857142857142858,2.7691455647518537,"(37.5, 52.0]",Q3
36003,2020-05-15,46430,44,0,44,27,1009,1.2857142857142858,2.7691455647518537,"(37.5, 52.0]",Q3
36003,2020-05-16,46430,44,0,44,36,1045,1.1428571428571428,2.46146272422387,"(37.5, 52.0]",Q3
36003,2020-05-17,46430,44,0,44,89,1134,0.8571428571428571,1.8460970431679025,"(37.5, 52.0]",Q3
36003,2020-05-18,46430,44,0,44,28,1162,0.2857142857142857,0.6153656810559675,"(37.5, 52.0]",Q3
36003,2020-05-19,46430,44,0,44,49,1211,0.0,0.0,"(37.5, 52.0]",Q3
36003,2020-05-20,46430,44,0,44,68,1279,0.0,0.0,"(37.5, 52.0]",Q3
36003,2020-05-21,46430,44,0,44,47,1326,0.0,0.0,"(37.5, 52.0]",Q3
36003,2020-05-22,46430,44,0,44,26,1352,0.0,0.0,"(37.5, 52.0]",Q3
36003,2020-05-23,46430,44,0,44,33,1385,0.0,0.0,"(37.5, 52.0]",Q3
36003,2020-05-24,46430,44,0,44,53,1438,0.0,0.0,"(37.5, 52.0]",Q3
36003,2020-05-25,46430,44,0,44,28,1466,0.0,0.0,"(37.5, 52.0]",Q3
36003,2020-05-26,46430,44,1,45,96,1562,0.14285714285714285,0.3076828405279837,"(37.5, 52.0]",Q3
36003,2020-05-27,46430,44,0,45,98,1660,0.14285714285714285,0.3076828405279837,"(37.5, 52.0]",Q3
36003,2020-05-28,46430,44,0,45,60,1720,0.14285714285714285,0.3076828405279837,"(37.5, 52.0]",Q3
36003,2020-05-29,46430,44,0,45,64,1784,0.14285714285714285,0.3076828405279837,"(37.5, 52.0]",Q3
36003,2020-05-30,46430,44,0,45,51,1835,0.14285714285714285,0.3076828405279837,"(37.5, 52.0]",Q3
36003,2020-05-31,46430,44,3,48,100,1935,0.5714285714285714,1.230731362111935,"(37.5, 52.0]",Q3
36003,2020-06-01,46430,44,0,48,160,2095,0.5714285714285714,1.230731362111935,"(37.5, 52.0]",Q3
36003,2020-06-02,46430,44,1,49,181,2276,0.5714285714285714,1.230731362111935,"(37.5, 52.0]",Q3
36003,2020-06-03,46430,44,0,49,131,2407,0.5714285714285714,1.230731362111935,"(37.5, 52.0]",Q3
36003,2020-06-04,46430,44,2,51,154,2561,0.8571428571428571,1.8460970431679025,"(37.5, 52.0]",Q3
36003,2020-06-05,46430,44,0,51,309,2870,0.8571428571428571,1.8460970431679025,"(37.5, 52.0]",Q3
36003,2020-06-06,46430,44,0,51,98,2968,0.8571428571428571,1.8460970431679025,"(37.5, 52.0]",Q3
36003,2020-06-07,46430,44,0,51,149,3117,0.42857142857142855,0.9230485215839512,"(37.5, 52.0]",Q3
36005,2020-03-02,1432132,100,0,0,0,0,0.0,0.0,"(52.0, 100.0]",Q4
36005,2020-03-03,1432132,100,0,0,1,1,0.0,0.0,"(52.0, 100.0]",Q4
36005,2020-03-04,1432132,100,0,0,0,1,0.0,0.0,"(52.0, 100.0]",Q4
36005,2020-03-05,1432132,100,0,0,5,6,0.0,0.0,"(52.0, 100.0]",Q4
36005,2020-03-06,1432132,100,0,0,6,12,0.0,0.0,"(52.0, 100.0]",Q4
36005,2020-03-07,1432132,100,0,0,17,29,0.0,0.0,"(52.0, 100.0]",Q4
36005,2020-03-08,1432132,100,1,1,16,45,0.14285714285714285,0.00997513796613321,"(52.0, 100.0]",Q4
36005,2020-03-09,1432132,100,4,5,31,76,0.7142857142857143,0.049875689830666044,"(52.0, 100.0]",Q4
36005,2020-03-10,1432132,100,0,5,47,123,0.7142857142857143,0.049875689830666044,"(52.0, 100.0]",Q4
36005,2020-03-11,1432132,100,2,7,31,154,1.0,0.06982596576293247,"(52.0, 100.0]",Q4
36005,2020-03-12,1432132,100,3,10,36,190,1.4285714285714286,0.09975137966133209,"(52.0, 100.0]",Q4
36005,2020-03-13,1432132,100,10,20,99,289,2.857142857142857,0.19950275932266417,"(52.0, 100.0]",Q4
36005,2020-03-14,1432132,100,8,28,80,369,4.0,0.2793038630517299,"(52.0, 100.0]",Q4
36005,2020-03-15,1432132,100,29,57,116,485,8.0,0.5586077261034598,"(52.0, 100.0]",Q4
36005,2020-03-16,1432132,100,29,86,151,636,11.571428571428571,0.80798617525679,"(52.0, 100.0]",Q4
36005,2020-03-17,1432132,100,123,209,433,1069,29.142857142857142,2.034928145091175,"(52.0, 100.0]",Q4
36005,2020-03-18,1432132,100,154,363,597,1666,50.857142857142854,3.551149115943422,"(52.0, 100.0]",Q4
36005,2020-03-19,1432132,100,191,554,605,2271,77.71428571428571,5.426475053576466,"(52.0, 100.0]",Q4
36005,2020-03-20,1432132,100,297,851,884,3155,118.71428571428571,8.289339649856696,"(52.0, 100.0]",Q4
36005,2020-03-21,1432132,100,367,1218,1044,4199,170.0,11.87041417969852,"(52.0, 100.0]",Q4
36005,2020-03-22,1432132,100,606,1824,1276,5475,252.42857142857142,17.62606878615738,"(52.0, 100.0]",Q4
36005,2020-03-23,1432132,100,455,2279,970,6445,313.2857142857143,21.875477559730125,"(52.0, 100.0]",Q4
36005,2020-03-24,1432132,100,611,2890,1188,7633,383.0,26.743344887203136,"(52.0, 100.0]",Q4
36005,2020-03-25,1432132,100,838,3728,1770,9403,480.7142857142857,33.566339256038255,"(52.0, 100.0]",Q4
36005,2020-03-26,1432132,100,829,4557,1428,10831,571.8571428571429,39.93047727843124,"(52.0, 100.0]",Q4
36005,2020-03-27,1432132,100,846,5403,1478,12309,650.2857142857143,45.40682802183837,"(52.0, 100.0]",Q4
36005,2020-03-28,1432132,100,901,6304,1529,13838,726.5714285714286,50.733551695753505,"(52.0, 100.0]",Q4
36005,2020-03-29,1432132,100,658,6962,1160,14998,734.0,51.252258869992424,"(52.0, 100.0]",Q4
36005,2020-03-30,1432132,100,804,7766,1341,16339,783.8571428571429,54.733582020172925,"(52.0, 100.0]",Q4
36005,2020-03-31,1432132,100,1095,8861,1818,18157,853.0,59.5615487957814,"(52.0, 100.0]",Q4
36005,2020-04-01,1432132,100,1066,9927,1754,19911,885.5714285714286,61.835880252059766,"(52.0, 100.0]",Q4
36005,2020-04-02,1432132,100,1159,11086,1946,21857,932.7142857142857,65.12767578088372,"(52.0, 100.0]",Q4
36005,2020-04-03,1432132,100,1229,12315,2108,23965,987.4285714285714,68.94815362191275,"(52.0, 100.0]",Q4
36005,2020-04-04,1432132,100,1053,13368,1778,25743,1009.1428571428571,70.46437459276498,"(52.0, 100.0]",Q4
36005,2020-04-05,1432132,100,959,14327,1628,27371,1052.142857142857,73.46689112057109,"(52.0, 100.0]",Q4
36005,2020-04-06,1432132,100,1021,15348,1996,29367,1083.142857142857,75.63149605922199,"(52.0, 100.0]",Q4
36005,2020-04-07,1432132,100,1278,16626,2562,31929,1109.2857142857142,77.45694630702437,"(52.0, 100.0]",Q4
36005,2020-04-08,1432132,100,1166,17792,2348,34277,1123.5714285714287,78.4544601036377,"(52.0, 100.0]",Q4
36005,2020-04-09,1432132,100,1368,19160,2637,36914,1153.4285714285713,80.53926393855953,"(52.0, 100.0]",Q4
36005,2020-04-10,1432132,100,1317,20477,2580,39494,1166.0,81.41707607957926,"(52.0, 100.0]",Q4
36005,2020-04-11,1432132,100,964,21441,2081,41575,1153.2857142857142,80.52928880059339,"(52.0, 100.0]",Q4
36005,2020-04-12,1432132,100,764,22205,1623,43198,1125.4285714285713,78.58413689719742,"(52.0, 100.0]",Q4
36005,2020-04-13,1432132,100,1061,23266,2294,45492,1131.142857142857,78.98314241584275,"(52.0, 100.0]",Q4
36005,2020-04-14,1432132,100,1387,24653,2622,48114,1146.7142857142858,80.07043245415127,"(52.0, 100.0]",Q4
36005,2020-04-15,1432132,100,1279,25932,2939,51053,1162.857142857143,81.19762304432433,"(52.0, 100.0]",Q4
36005,2020-04-16,1432132,100,1103,27035,2793,53846,1125.0,78.55421148329903,"(52.0, 100.0]",Q4
36005,2020-04-17,1432132,100,984,28019,2597,56443,1077.4285714285713,75.23249054057666,"(52.0, 100.0]",Q4
36005,2020-04-18,1432132,100,804,28823,2162,58605,1054.5714285714287,73.63646846599536,"(52.0, 100.0]",Q4
36005,2020-04-19,1432132,100,549,29372,1707,60312,1023.8571428571429,71.49181380327671,"(52.0, 100.0]",Q4
36005,2020-04-20,1432132,100,617,29989,2050,62362,960.4285714285714,67.06285254631358,"(52.0, 100.0]",Q4
36005,2020-04-21,1432132,100,879,30868,2942,65304,887.8571428571429,61.995482459517895,"(52.0, 100.0]",Q4
36005,2020-04-22,1432132,100,791,31659,3084,68388,818.1428571428571,57.127615132044895,"(52.0, 100.0]",Q4
36005,2020-04-23,1432132,100,1042,32701,3691,72079,809.4285714285714,56.51913171611076,"(52.0, 100.0]",Q4
36005,2020-04-24,1432132,100,1482,34183,4800,76879,880.5714285714286,61.4867504232451,"(52.0, 100.0]",Q4
36005,2020-04-25,1432132,100,787,34970,2967,79846,878.1428571428571,61.31717307782084,"(52.0, 100.0]",Q4
36005,2020-04-26,1432132,100,586,35556,2363,82209,883.4285714285714,61.68625318256777,"(52.0, 100.0]",Q4
36005,2020-04-27,1432132,100,438,35994,2107,84316,857.8571428571429,59.90070348662992,"(52.0, 100.0]",Q4
36005,2020-04-28,1432132,100,606,36600,2938,87254,818.8571428571429,57.17749082187556,"(52.0, 100.0]",Q4
36005,2020-04-29,1432132,100,644,37244,2977,90231,797.8571428571429,55.71114554085398,"(52.0, 100.0]",Q4
36005,2020-04-30,1432132,100,541,37785,2824,93055,726.2857142857143,50.713601419821245,"(52.0, 100.0]",Q4
36005,2020-05-01,1432132,100,665,38450,3694,96749,609.5714285714286,42.56391370149041,"(52.0, 100.0]",Q4
36005,2020-05-02,1432132,100,466,38916,2857,99606,563.7142857142857,39.36189441436164,"(52.0, 100.0]",Q4
36005,2020-05-03,1432132,100,307,39223,1869,101475,523.8571428571429,36.57883092181048,"(52.0, 100.0]",Q4
36005,2020-05-04,1432132,100,253,39476,2001,103476,497.42857142857144,34.73343039807583,"(52.0, 100.0]",Q4
36005,2020-05-05,1432132,100,363,39839,2657,106133,462.7142857142857,32.309471872305465,"(52.0, 100.0]",Q4
36005,2020-05-06,1432132,100,342,40181,2786,108919,419.57142857142856,29.296980206533235,"(52.0, 100.0]",Q4
36005,2020-05-07,1432132,100,352,40533,3078,111997,392.57142857142856,27.411679130934058,"(52.0, 100.0]",Q4
36005,2020-05-08,1432132,100,271,40804,2873,114870,336.2857142857143,23.481474772277576,"(52.0, 100.0]",Q4
36005,2020-05-09,1432132,100,255,41059,2935,117805,306.14285714285717,21.37672066142347,"(52.0, 100.0]",Q4
36005,2020-05-10,1432132,100,237,41296,2140,119945,296.14285714285717,20.678461003794144,"(52.0, 100.0]",Q4
36005,2020-05-11,1432132,100,145,41441,1510,121455,280.7142857142857,19.601146103451757,"(52.0, 100.0]",Q4
36005,2020-05-12,1432132,100,236,41677,2678,124133,262.57142857142856,18.334303581752838,"(52.0, 100.0]",Q4
36005,2020-05-13,1432132,100,303,41980,3338,127471,257.0,17.945273201073647,"(52.0, 100.0]",Q4
36005,2020-05-14,1432132,100,539,42519,4408,131879,283.7142857142857,19.810624000740557,"(52.0, 100.0]",Q4
36005,2020-05-15,1432132,100,293,42812,3632,135511,286.85714285714283,20.030077035995483,"(52.0, 100.0]",Q4
36005,2020-05-16,1432132,100,210,43022,2861,138372,280.42857142857144,19.581195827519494,"(52.0, 100.0]",Q4
36005,2020-05-17,1432132,100,136,43158,2126,140498,266.0,18.573706892940034,"(52.0, 100.0]",Q4
36005,2020-05-18,1432132,100,112,43270,2102,142600,261.2857142857143,18.24452734005764,"(52.0, 100.0]",Q4
36005,2020-05-19,1432132,100,148,43418,2682,145282,248.71428571428572,17.366715199037916,"(52.0, 100.0]",Q4
36005,2020-05-20,1432132,100,185,43603,3618,148900,231.85714285714286,16.189648919034198,"(52.0, 100.0]",Q4
36005,2020-05-21,1432132,100,163,43766,3421,152321,178.14285714285714,12.438997043768111,"(52.0, 100.0]",Q4
36005,2020-05-22,1432132,100,155,43921,3518,155839,158.42857142857142,11.06242800444173,"(52.0, 100.0]",Q4
36005,2020-05-23,1432132,100,216,44137,4575,160414,159.28571428571428,11.122278832238527,"(52.0, 100.0]",Q4
36005,2020-05-24,1432132,100,110,44247,2445,162859,155.57142857142858,10.862925245119065,"(52.0, 100.0]",Q4
36005,2020-05-25,1432132,100,117,44364,2233,165092,156.28571428571428,10.91280093494973,"(52.0, 100.0]",Q4
36005,2020-05-26,1432132,100,139,44503,3064,168156,155.0,10.823024693254531,"(52.0, 100.0]",Q4
36005,2020-05-27,1432132,100,250,44753,5657,173813,164.28571428571428,11.471408661053191,"(52.0, 100.0]",Q4
36005,2020-05-28,1432132,100,221,44974,5781,179594,172.57142857142858,12.049966663088917,"(52.0, 100.0]",Q4
36005,2020-05-29,1432132,100,142,45116,4817,184411,170.71428571428572,11.920289869529187,"(52.0, 100.0]",Q4
36005,2020-05-30,1432132,100,137,45253,4338,188749,159.42857142857142,11.13225397020466,"(52.0, 100.0]",Q4
36005,2020-05-31,1432132,100,106,45359,3997,192746,158.85714285714286,11.09235341834013,"(52.0, 100.0]",Q4
36005,2020-06-01,1432132,100,107,45466,4069,196815,157.42857142857142,10.992602038678797,"(52.0, 100.0]",Q4
36005,2020-06-02,1432132,100,105,45571,3579,200394,152.57142857142858,10.65344734783027,"(52.0, 100.0]",Q4
36005,2020-06-03,1432132,100,117,45688,4303,204697,133.57142857142858,9.326753998334551,"(52.0, 100.0]",Q4
36005,2020-06-04,1432132,100,90,45778,4606,209303,114.85714285714286,8.020010924771102,"(52.0, 100.0]",Q4
36005,2020-06-05,1432132,100,104,45882,5144,214447,109.42857142857143,7.640955682058038,"(52.0, 100.0]",Q4
36005,2020-06-06,1432132,100,98,45980,4164,218611,103.85714285714286,7.2519253013788445,"(52.0, 100.0]",Q4
36005,2020-06-07,1432132,100,72,46052,3718,222329,99.0,6.9127706105303135,"(52.0, 100.0]",Q4
36007,2020-03-02,191659,52,0,0,0,0,0.0,0.0,"(37.5, 52.0]",Q3
36007,2020-03-03,191659,52,0,0,0,0,0.0,0.0,"(37.5, 52.0]",Q3
36007,2020-03-04,191659,52,0,0,0,0,0.0,0.0,"(37.5, 52.0]",Q3
36007,2020-03-05,191659,52,0,0,0,0,0.0,0.0,"(37.5, 52.0]",Q3
36007,2020-03-06,191659,52,0,0,0,0,0.0,0.0,"(37.5, 52.0]",Q3
36007,2020-03-07,191659,52,0,0,0,0,0.0,0.0,"(37.5, 52.0]",Q3
36007,2020-03-08,191659,52,0,0,2,2,0.0,0.0,"(37.5, 52.0]",Q3
36007,2020-03-09,191659,52,0,0,1,3,0.0,0.0,"(37.5, 52.0]",Q3
36007,2020-03-10,191659,52,0,0,1,4,0.0,0.0,"(37.5, 52.0]",Q3
36007,2020-03-11,191659,52,0,0,1,5,0.0,0.0,"(37.5, 52.0]",Q3
36007,2020-03-12,191659,52,1,1,2,7,0.14285714285714285,0.07453714297640228,"(37.5, 52.0]",Q3
36007,2020-03-13,191659,52,0,1,2,9,0.14285714285714285,0.07453714297640228,"(37.5, 52.0]",Q3
36007,2020-03-14,191659,52,0,1,3,12,0.14285714285714285,0.07453714297640228,"(37.5, 52.0]",Q3
36007,2020-03-15,191659,52,0,1,2,14,0.14285714285714285,0.07453714297640228,"(37.5, 52.0]",Q3
36007,2020-03-16,191659,52,0,1,1,15,0.14285714285714285,0.07453714297640228,"(37.5, 52.0]",Q3
36007,2020-03-17,191659,52,0,1,6,21,0.14285714285714285,0.07453714297640228,"(37.5, 52.0]",Q3
36007,2020-03-18,191659,52,1,2,9,30,0.2857142857142857,0.14907428595280456,"(37.5, 52.0]",Q3
36007,2020-03-19,191659,52,0,2,3,33,0.14285714285714285,0.07453714297640228,"(37.5, 52.0]",Q3
36007,2020-03-20,191659,52,0,2,16,49,0.14285714285714285,0.07453714297640228,"(37.5, 52.0]",Q3
36007,2020-03-21,191659,52,1,3,5,54,0.2857142857142857,0.14907428595280456,"(37.5, 52.0]",Q3
36007,2020-03-22,191659,52,4,7,20,74,0.8571428571428571,0.4472228578584137,"(37.5, 52.0]",Q3
36007,2020-03-23,191659,52,2,9,18,92,1.1428571428571428,0.5962971438112182,"(37.5, 52.0]",Q3
36007,2020-03-24,191659,52,2,11,13,105,1.4285714285714286,0.7453714297640229,"(37.5, 52.0]",Q3
36007,2020-03-25,191659,52,5,16,37,142,2.0,1.043520001669632,"(37.5, 52.0]",Q3
36007,2020-03-26,191659,52,2,18,25,167,2.2857142857142856,1.1925942876224365,"(37.5, 52.0]",Q3
36007,2020-03-27,191659,52,5,23,37,204,3.0,1.565280002504448,"(37.5, 52.0]",Q3
36007,2020-03-28,191659,52,6,29,45,249,3.7142857142857144,1.9379657173864595,"(37.5, 52.0]",Q3
36007,2020-03-29,191659,52,6,35,36,285,4.0,2.087040003339264,"(37.5, 52.0]",Q3
36007,2020-03-30,191659,52,3,38,48,333,4.142857142857143,2.1615771463156666,"(37.5, 52.0]",Q3
36007,2020-03-31,191659,52,4,42,35,368,4.428571428571429,2.3106514322684713,"(37.5, 52.0]",Q3
36007,2020-04-01,191659,52,4,46,43,411,4.285714285714286,2.2361142892920687,"(37.5, 52.0]",Q3
36007,2020-04-02,191659,52,10,56,72,483,5.428571428571429,2.832411433103287,"(37.5, 52.0]",Q3
36007,2020-04-03,191659,52,9,65,55,538,6.0,3.130560005008896,"(37.5, 52.0]",Q3
36007,2020-04-04,191659,52,6,71,36,574,6.0,3.130560005008896,"(37.5, 52.0]",Q3
36007,2020-04-05,191659,52,5,76,33,607,5.857142857142857,3.0560228620324934,"(37.5, 52.0]",Q3
36007,2020-04-06,191659,52,10,86,47,654,6.857142857142857,3.5777828628673096,"(37.5, 52.0]",Q3
36007,2020-04-07,191659,52,2,88,24,678,6.571428571428571,3.428708576914505,"(37.5, 52.0]",Q3
36007,2020-04-08,191659,52,17,105,82,760,8.428571428571429,4.397691435607735,"(37.5, 52.0]",Q3
36007,2020-04-09,191659,52,7,112,58,818,8.0,4.174080006678528,"(37.5, 52.0]",Q3
36007,2020-04-10,191659,52,5,117,31,849,7.428571428571429,3.875931434772919,"(37.5, 52.0]",Q3
36007,2020-04-11,191659,52,9,126,60,909,7.857142857142857,4.099542863702125,"(37.5, 52.0]",Q3
36007,2020-04-12,191659,52,7,133,39,948,8.142857142857142,4.2486171496549305,"(37.5, 52.0]",Q3
36007,2020-04-13,191659,52,13,146,90,1038,8.571428571428571,4.472228578584137,"(37.5, 52.0]",Q3
36007,2020-04-14,191659,52,7,153,73,1111,9.285714285714286,4.844914293466149,"(37.5, 52.0]",Q3
36007,2020-04-15,191659,52,14,167,74,1185,8.857142857142858,4.6213028645369425,"(37.5, 52.0]",Q3
36007,2020-04-16,191659,52,11,178,82,1267,9.428571428571429,4.919451436442551,"(37.5, 52.0]",Q3
36007,2020-04-17,191659,52,8,186,64,1331,9.857142857142858,5.143062865371758,"(37.5, 52.0]",Q3
36007,2020-04-18,191659,52,6,192,52,1383,9.428571428571429,4.919451436442551,"(37.5, 52.0]",Q3
36007,2020-04-19,191659,52,7,199,43,1426,9.428571428571429,4.919451436442551,"(37.5, 52.0]",Q3
36007,2020-04-20,191659,52,6,205,47,1473,8.428571428571429,4.397691435607735,"(37.5, 52.0]",Q3
36007,2020-04-21,191659,52,14,219,54,1527,9.428571428571429,4.919451436442551,"(37.5, 52.0]",Q3
36007,2020-04-22,191659,52,5,224,102,1629,8.142857142857142,4.2486171496549305,"(37.5, 52.0]",Q3
36007,2020-04-23,191659,52,8,232,85,1714,7.714285714285714,4.025005720725724,"(37.5, 52.0]",Q3
36007,2020-04-24,191659,52,19,251,212,1926,9.285714285714286,4.844914293466149,"(37.5, 52.0]",Q3
36007,2020-04-25,191659,52,6,257,105,2031,9.285714285714286,4.844914293466149,"(37.5, 52.0]",Q3
36007,2020-04-26,191659,52,4,261,69,2100,8.857142857142858,4.6213028645369425,"(37.5, 52.0]",Q3
36007,2020-04-27,191659,52,5,266,60,2160,8.714285714285714,4.546765721560539,"(37.5, 52.0]",Q3
36007,2020-04-28,191659,52,7,273,87,2247,7.714285714285714,4.025005720725724,"(37.5, 52.0]",Q3
36007,2020-04-29,191659,52,11,284,114,2361,8.571428571428571,4.472228578584137,"(37.5, 52.0]",Q3
36007,2020-04-30,191659,52,15,299,110,2471,9.571428571428571,4.993988579418953,"(37.5, 52.0]",Q3
36007,2020-05-01,191659,52,6,305,114,2585,7.714285714285714,4.025005720725724,"(37.5, 52.0]",Q3
36007,2020-05-02,191659,52,22,327,415,3000,10.0,5.2176000083481595,"(37.5, 52.0]",Q3
36007,2020-05-03,191659,52,7,334,353,3353,10.428571428571429,5.441211437277367,"(37.5, 52.0]",Q3
36007,2020-05-04,191659,52,4,338,180,3533,10.285714285714286,5.366674294300965,"(37.5, 52.0]",Q3
36007,2020-05-05,191659,52,7,345,273,3806,10.285714285714286,5.366674294300965,"(37.5, 52.0]",Q3
36007,2020-05-06,191659,52,15,360,333,4139,10.857142857142858,5.664822866206574,"(37.5, 52.0]",Q3
36007,2020-05-07,191659,52,4,364,214,4353,9.285714285714286,4.844914293466149,"(37.5, 52.0]",Q3
36007,2020-05-08,191659,52,8,372,252,4605,9.571428571428571,4.993988579418953,"(37.5, 52.0]",Q3
36007,2020-05-09,191659,52,1,373,317,4922,6.571428571428571,3.428708576914505,"(37.5, 52.0]",Q3
36007,2020-05-10,191659,52,5,378,319,5241,6.285714285714286,3.2796342909617002,"(37.5, 52.0]",Q3
36007,2020-05-11,191659,52,1,379,271,5512,5.857142857142857,3.0560228620324934,"(37.5, 52.0]",Q3
36007,2020-05-12,191659,52,3,382,291,5803,5.285714285714286,2.7578742901268845,"(37.5, 52.0]",Q3
36007,2020-05-13,191659,52,1,383,343,6146,3.2857142857142856,1.7143542884572525,"(37.5, 52.0]",Q3
36007,2020-05-14,191659,52,7,390,343,6489,3.7142857142857144,1.9379657173864595,"(37.5, 52.0]",Q3
36007,2020-05-15,191659,52,23,413,458,6947,5.857142857142857,3.0560228620324934,"(37.5, 52.0]",Q3
36007,2020-05-16,191659,52,1,414,486,7433,5.857142857142857,3.0560228620324934,"(37.5, 52.0]",Q3
36007,2020-05-17,191659,52,9,423,379,7812,6.428571428571429,3.3541714339381032,"(37.5, 52.0]",Q3
36007,2020-05-18,191659,52,6,429,295,8107,7.142857142857143,3.7268571488201148,"(37.5, 52.0]",Q3
36007,2020-05-19,191659,52,7,436,639,8746,7.714285714285714,4.025005720725724,"(37.5, 52.0]",Q3
36007,2020-05-20,191659,52,15,451,419,9165,9.714285714285714,5.068525722395355,"(37.5, 52.0]",Q3
36007,2020-05-21,191659,52,17,468,820,9985,11.142857142857142,5.813897152159378,"(37.5, 52.0]",Q3
36007,2020-05-22,191659,52,17,485,645,10630,10.285714285714286,5.366674294300965,"(37.5, 52.0]",Q3
36007,2020-05-23,191659,52,16,501,629,11259,12.428571428571429,6.484731438947,"(37.5, 52.0]",Q3
36007,2020-05-24,191659,52,18,519,669,11928,13.714285714285714,7.155565725734619,"(37.5, 52.0]",Q3
36007,2020-05-25,191659,52,3,522,536,12464,13.285714285714286,6.931954296805413,"(37.5, 52.0]",Q3
36007,2020-05-26,191659,52,6,528,369,12833,13.142857142857142,6.85741715382901,"(37.5, 52.0]",Q3
36007,2020-05-27,191659,52,17,545,523,13356,13.428571428571429,7.006491439781815,"(37.5, 52.0]",Q3
36007,2020-05-28,191659,52,12,557,614,13970,12.714285714285714,6.633805724899804,"(37.5, 52.0]",Q3
36007,2020-05-29,191659,52,4,561,531,14501,10.857142857142858,5.664822866206574,"(37.5, 52.0]",Q3
36007,2020-05-30,191659,52,5,566,1002,15503,9.285714285714286,4.844914293466149,"(37.5, 52.0]",Q3
36007,2020-05-31,191659,52,8,574,777,16280,7.857142857142857,4.099542863702125,"(37.5, 52.0]",Q3
36007,2020-06-01,191659,52,4,578,629,16909,8.0,4.174080006678528,"(37.5, 52.0]",Q3
36007,2020-06-02,191659,52,11,589,826,17735,8.714285714285714,4.546765721560539,"(37.5, 52.0]",Q3
36007,2020-06-03,191659,52,4,593,631,18366,6.857142857142857,3.5777828628673096,"(37.5, 52.0]",Q3
36007,2020-06-04,191659,52,12,605,1417,19783,6.857142857142857,3.5777828628673096,"(37.5, 52.0]",Q3
36007,2020-06-05,191659,52,8,613,1311,21094,7.428571428571429,3.875931434772919,"(37.5, 52.0]",Q3
36007,2020-06-06,191659,52,7,620,950,22044,7.714285714285714,4.025005720725724,"(37.5, 52.0]",Q3
36007,2020-06-07,191659,52,4,624,745,22789,7.142857142857143,3.7268571488201148,"(37.5, 52.0]",Q3
36009,2020-03-02,76840,54,0,0,0,0,0.0,0.0,"(52.0, 100.0]",Q4
36009,2020-03-03,76840,54,0,0,0,0,0.0,0.0,"(52.0, 100.0]",Q4
36009,2020-03-04,76840,54,0,0,0,0,0.0,0.0,"(52.0, 100.0]",Q4
36009,2020-03-05,76840,54,0,0,0,0,0.0,0.0,"(52.0, 100.0]",Q4
36009,2020-03-06,76840,54,0,0,0,0,0.0,0.0,"(52.0, 100.0]",Q4
36009,2020-03-07,76840,54,0,0,0,0,0.0,0.0,"(52.0, 100.0]",Q4
36009,2020-03-08,76840,54,0,0,0,0,0.0,0.0,"(52.0, 100.0]",Q4
36009,2020-03-09,76840,54,0,0,0,0,0.0,0.0,"(52.0, 100.0]",Q4
36009,2020-03-10,76840,54,0,0,0,0,0.0,0.0,"(52.0, 100.0]",Q4
36009,2020-03-11,76840,54,0,0,0,0,0.0,0.0,"(52.0, 100.0]",Q4
36009,2020-03-12,76840,54,0,0,2,2,0.0,0.0,"(52.0, 100.0]",Q4
36009,2020-03-13,76840,54,0,0,2,4,0.0,0.0,"(52.0, 100.0]",Q4
36009,2020-03-14,76840,54,0,0,1,5,0.0,0.0,"(52.0, 100.0]",Q4
36009,2020-03-15,76840,54,0,0,2,7,0.0,0.0,"(52.0, 100.0]",Q4
36009,2020-03-16,76840,54,0,0,0,7,0.0,0.0,"(52.0, 100.0]",Q4
36009,2020-03-17,76840,54,0,0,0,7,0.0,0.0,"(52.0, 100.0]",Q4
36009,2020-03-18,76840,54,0,0,5,12,0.0,0.0,"(52.0, 100.0]",Q4
36009,2020-03-19,76840,54,0,0,2,14,0.0,0.0,"(52.0, 100.0]",Q4
36009,2020-03-20,76840,54,0,0,10,24,0.0,0.0,"(52.0, 100.0]",Q4
36009,2020-03-21,76840,54,0,0,23,47,0.0,0.0,"(52.0, 100.0]",Q4
36009,2020-03-22,76840,54,0,0,14,61,0.0,0.0,"(52.0, 100.0]",Q4
36009,2020-03-23,76840,54,0,0,12,73,0.0,0.0,"(52.0, 100.0]",Q4
36009,2020-03-24,76840,54,0,0,3,76,0.0,0.0,"(52.0, 100.0]",Q4
36009,2020-03-25,76840,54,0,0,12,88,0.0,0.0,"(52.0, 100.0]",Q4
36009,2020-03-26,76840,54,0,0,13,101,0.0,0.0,"(52.0, 100.0]",Q4
36009,2020-03-27,76840,54,1,1,25,126,0.14285714285714285,0.18591507399419943,"(52.0, 100.0]",Q4
36009,2020-03-28,76840,54,3,4,13,139,0.5714285714285714,0.7436602959767977,"(52.0, 100.0]",Q4
36009,2020-03-29,76840,54,2,6,7,146,0.8571428571428571,1.1154904439651967,"(52.0, 100.0]",Q4
36009,2020-03-30,76840,54,0,6,5,151,0.8571428571428571,1.1154904439651967,"(52.0, 100.0]",Q4
36009,2020-03-31,76840,54,1,7,12,163,1.0,1.3014055179593962,"(52.0, 100.0]",Q4
36009,2020-04-01,76840,54,1,8,28,191,1.1428571428571428,1.4873205919535955,"(52.0, 100.0]",Q4
36009,2020-04-02,76840,54,1,9,24,215,1.2857142857142858,1.6732356659477952,"(52.0, 100.0]",Q4
36009,2020-04-03,76840,54,0,9,8,223,1.1428571428571428,1.4873205919535955,"(52.0, 100.0]",Q4
36009,2020-04-04,76840,54,1,10,12,235,0.8571428571428571,1.1154904439651967,"(52.0, 100.0]",Q4
36009,2020-04-05,76840,54,2,12,16,251,0.8571428571428571,1.1154904439651967,"(52.0, 100.0]",Q4
36009,2020-04-06,76840,54,1,13,14,265,1.0,1.3014055179593962,"(52.0, 100.0]",Q4
36009,2020-04-07,76840,54,2,15,19,284,1.1428571428571428,1.4873205919535955,"(52.0, 100.0]",Q4
36009,2020-04-08,76840,54,2,17,15,299,1.2857142857142858,1.6732356659477952,"(52.0, 100.0]",Q4
36009,2020-04-09,76840,54,1,18,26,325,1.2857142857142858,1.6732356659477952,"(52.0, 100.0]",Q4
36009,2020-04-10,76840,54,1,19,7,332,1.4285714285714286,1.8591507399419944,"(52.0, 100.0]",Q4
36009,2020-04-11,76840,54,9,28,32,364,2.5714285714285716,3.3464713318955903,"(52.0, 100.0]",Q4
36009,2020-04-12,76840,54,0,28,6,370,2.2857142857142856,2.974641183907191,"(52.0, 100.0]",Q4
36009,2020-04-13,76840,54,4,32,13,383,2.7142857142857144,3.5323864058897896,"(52.0, 100.0]",Q4
36009,2020-04-14,76840,54,0,32,11,394,2.4285714285714284,3.1605562579013906,"(52.0, 100.0]",Q4
36009,2020-04-15,76840,54,0,32,14,408,2.142857142857143,2.7887261099129916,"(52.0, 100.0]",Q4
36009,2020-04-16,76840,54,2,34,31,439,2.2857142857142856,2.974641183907191,"(52.0, 100.0]",Q4
36009,2020-04-17,76840,54,0,34,15,454,2.142857142857143,2.7887261099129916,"(52.0, 100.0]",Q4
36009,2020-04-18,76840,54,0,34,17,471,0.8571428571428571,1.1154904439651967,"(52.0, 100.0]",Q4
36009,2020-04-19,76840,54,0,34,1,472,0.8571428571428571,1.1154904439651967,"(52.0, 100.0]",Q4
36009,2020-04-20,76840,54,1,35,8,480,0.42857142857142855,0.5577452219825983,"(52.0, 100.0]",Q4
36009,2020-04-21,76840,54,2,37,34,514,0.7142857142857143,0.9295753699709972,"(52.0, 100.0]",Q4
36009,2020-04-22,76840,54,0,37,40,554,0.7142857142857143,0.9295753699709972,"(52.0, 100.0]",Q4
36009,2020-04-23,76840,54,2,39,32,586,0.7142857142857143,0.9295753699709972,"(52.0, 100.0]",Q4
36009,2020-04-24,76840,54,6,45,102,688,1.5714285714285714,2.045065813936194,"(52.0, 100.0]",Q4
36009,2020-04-25,76840,54,0,45,24,712,1.5714285714285714,2.045065813936194,"(52.0, 100.0]",Q4
36009,2020-04-26,76840,54,0,45,21,733,1.5714285714285714,2.045065813936194,"(52.0, 100.0]",Q4
36009,2020-04-27,76840,54,0,45,15,748,1.4285714285714286,1.8591507399419944,"(52.0, 100.0]",Q4
36009,2020-04-28,76840,54,2,47,76,824,1.4285714285714286,1.8591507399419944,"(52.0, 100.0]",Q4
36009,2020-04-29,76840,54,0,47,85,909,1.4285714285714286,1.8591507399419944,"(52.0, 100.0]",Q4
36009,2020-04-30,76840,54,2,49,78,987,1.4285714285714286,1.8591507399419944,"(52.0, 100.0]",Q4
36009,2020-05-01,76840,54,1,50,80,1067,0.7142857142857143,0.9295753699709972,"(52.0, 100.0]",Q4
36009,2020-05-02,76840,54,3,53,54,1121,1.1428571428571428,1.4873205919535955,"(52.0, 100.0]",Q4
36009,2020-05-03,76840,54,0,53,7,1128,1.1428571428571428,1.4873205919535955,"(52.0, 100.0]",Q4
36009,2020-05-04,76840,54,0,53,14,1142,1.1428571428571428,1.4873205919535955,"(52.0, 100.0]",Q4
36009,2020-05-05,76840,54,1,54,47,1189,1.0,1.3014055179593962,"(52.0, 100.0]",Q4
36009,2020-05-06,76840,54,5,59,65,1254,1.7142857142857142,2.2309808879303934,"(52.0, 100.0]",Q4
36009,2020-05-07,76840,54,0,59,36,1290,1.4285714285714286,1.8591507399419944,"(52.0, 100.0]",Q4
36009,2020-05-08,76840,54,1,60,54,1344,1.4285714285714286,1.8591507399419944,"(52.0, 100.0]",Q4
36009,2020-05-09,76840,54,0,60,21,1365,1.0,1.3014055179593962,"(52.0, 100.0]",Q4
36009,2020-05-10,76840,54,1,61,103,1468,1.1428571428571428,1.4873205919535955,"(52.0, 100.0]",Q4
36009,2020-05-11,76840,54,0,61,29,1497,1.1428571428571428,1.4873205919535955,"(52.0, 100.0]",Q4
36009,2020-05-12,76840,54,0,61,77,1574,1.0,1.3014055179593962,"(52.0, 100.0]",Q4
36009,2020-05-13,76840,54,3,64,134,1708,0.7142857142857143,0.9295753699709972,"(52.0, 100.0]",Q4
36009,2020-05-14,76840,54,0,64,173,1881,0.7142857142857143,0.9295753699709972,"(52.0, 100.0]",Q4
36009,2020-05-15,76840,54,1,65,186,2067,0.7142857142857143,0.9295753699709972,"(52.0, 100.0]",Q4
36009,2020-05-16,76840,54,0,65,142,2209,0.7142857142857143,0.9295753699709972,"(52.0, 100.0]",Q4
36009,2020-05-17,76840,54,2,67,207,2416,0.8571428571428571,1.1154904439651967,"(52.0, 100.0]",Q4
36009,2020-05-18,76840,54,2,69,24,2440,1.1428571428571428,1.4873205919535955,"(52.0, 100.0]",Q4
36009,2020-05-19,76840,54,1,70,152,2592,1.2857142857142858,1.6732356659477952,"(52.0, 100.0]",Q4
36009,2020-05-20,76840,54,1,71,186,2778,1.0,1.3014055179593962,"(52.0, 100.0]",Q4
36009,2020-05-21,76840,54,3,74,125,2903,1.4285714285714286,1.8591507399419944,"(52.0, 100.0]",Q4
36009,2020-05-22,76840,54,4,78,176,3079,1.8571428571428572,2.416895961924593,"(52.0, 100.0]",Q4
36009,2020-05-23,76840,54,0,78,172,3251,1.8571428571428572,2.416895961924593,"(52.0, 100.0]",Q4
36009,2020-05-24,76840,54,3,81,311,3562,2.0,2.6028110359187924,"(52.0, 100.0]",Q4
36009,2020-05-25,76840,54,0,81,136,3698,1.7142857142857142,2.2309808879303934,"(52.0, 100.0]",Q4
36009,2020-05-26,76840,54,1,82,162,3860,1.7142857142857142,2.2309808879303934,"(52.0, 100.0]",Q4
36009,2020-05-27,76840,54,3,85,286,4146,2.0,2.6028110359187924,"(52.0, 100.0]",Q4
36009,2020-05-28,76840,54,1,86,147,4293,1.7142857142857142,2.2309808879303934,"(52.0, 100.0]",Q4
36009,2020-05-29,76840,54,1,87,189,4482,1.2857142857142858,1.6732356659477952,"(52.0, 100.0]",Q4
36009,2020-05-30,76840,54,1,88,183,4665,1.4285714285714286,1.8591507399419944,"(52.0, 100.0]",Q4
36009,2020-05-31,76840,54,1,89,215,4880,1.1428571428571428,1.4873205919535955,"(52.0, 100.0]",Q4
36009,2020-06-01,76840,54,0,89,333,5213,1.1428571428571428,1.4873205919535955,"(52.0, 100.0]",Q4
36009,2020-06-02,76840,54,1,90,375,5588,1.1428571428571428,1.4873205919535955,"(52.0, 100.0]",Q4
36009,2020-06-03,76840,54,1,91,290,5878,0.8571428571428571,1.1154904439651967,"(52.0, 100.0]",Q4
36009,2020-06-04,76840,54,1,92,304,6182,0.8571428571428571,1.1154904439651967,"(52.0, 100.0]",Q4
36009,2020-06-05,76840,54,0,92,416,6598,0.7142857142857143,0.9295753699709972,"(52.0, 100.0]",Q4
36009,2020-06-06,76840,54,2,94,193,6791,0.8571428571428571,1.1154904439651967,"(52.0, 100.0]",Q4
36009,2020-06-07,76840,54,1,95,245,7036,0.8571428571428571,1.1154904439651967,"(52.0, 100.0]",Q4
36011,2020-03-02,77145,40,0,0,0,0,0.0,0.0,"(37.5, 52.0]",Q3
36011,2020-03-03,77145,40,0,0,0,0,0.0,0.0,"(37.5, 52.0]",Q3
36011,2020-03-04,77145,40,0,0,0,0,0.0,0.0,"(37.5, 52.0]",Q3
36011,2020-03-05,77145,40,0,0,0,0,0.0,0.0,"(37.5, 52.0]",Q3
36011,2020-03-06,77145,40,0,0,0,0,0.0,0.0,"(37.5, 52.0]",Q3
36011,2020-03-07,77145,40,0,0,0,0,0.0,0.0,"(37.5, 52.0]",Q3
36011,2020-03-08,77145,40,0,0,0,0,0.0,0.0,"(37.5, 52.0]",Q3
36011,2020-03-09,77145,40,0,0,0,0,0.0,0.0,"(37.5, 52.0]",Q3
36011,2020-03-10,77145,40,0,0,0,0,0.0,0.0,"(37.5, 52.0]",Q3
36011,2020-03-11,77145,40,0,0,0,0,0.0,0.0,"(37.5, 52.0]",Q3
36011,2020-03-12,77145,40,0,0,0,0,0.0,0.0,"(37.5, 52.0]",Q3
36011,2020-03-13,77145,40,0,0,0,0,0.0,0.0,"(37.5, 52.0]",Q3
36011,2020-03-14,77145,40,0,0,3,3,0.0,0.0,"(37.5, 52.0]",Q3
36011,2020-03-15,77145,40,0,0,1,4,0.0,0.0,"(37.5, 52.0]",Q3
36011,2020-03-16,77145,40,0,0,2,6,0.0,0.0,"(37.5, 52.0]",Q3
36011,2020-03-17,77145,40,0,0,2,8,0.0,0.0,"(37.5, 52.0]",Q3
36011,2020-03-18,77145,40,0,0,2,10,0.0,0.0,"(37.5, 52.0]",Q3
36011,2020-03-19,77145,40,0,0,3,13,0.0,0.0,"(37.5, 52.0]",Q3
36011,2020-03-20,77145,40,0,0,8,21,0.0,0.0,"(37.5, 52.0]",Q3
36011,2020-03-21,77145,40,0,0,25,46,0.0,0.0,"(37.5, 52.0]",Q3
36011,2020-03-22,77145,40,2,2,33,79,0.2857142857142857,0.3703600825902984,"(37.5, 52.0]",Q3
36011,2020-03-23,77145,40,0,2,10,89,0.2857142857142857,0.3703600825902984,"(37.5, 52.0]",Q3
36011,2020-03-24,77145,40,0,2,5,94,0.2857142857142857,0.3703600825902984,"(37.5, 52.0]",Q3
36011,2020-03-25,77145,40,0,2,13,107,0.2857142857142857,0.3703600825902984,"(37.5, 52.0]",Q3
36011,2020-03-26,77145,40,0,2,25,132,0.2857142857142857,0.3703600825902984,"(37.5, 52.0]",Q3
36011,2020-03-27,77145,40,0,2,26,158,0.2857142857142857,0.3703600825902984,"(37.5, 52.0]",Q3
36011,2020-03-28,77145,40,0,2,32,190,0.2857142857142857,0.3703600825902984,"(37.5, 52.0]",Q3
36011,2020-03-29,77145,40,1,3,37,227,0.14285714285714285,0.1851800412951492,"(37.5, 52.0]",Q3
36011,2020-03-30,77145,40,0,3,10,237,0.14285714285714285,0.1851800412951492,"(37.5, 52.0]",Q3
36011,2020-03-31,77145,40,0,3,9,246,0.14285714285714285,0.1851800412951492,"(37.5, 52.0]",Q3
36011,2020-04-01,77145,40,1,4,25,271,0.2857142857142857,0.3703600825902984,"(37.5, 52.0]",Q3
36011,2020-04-02,77145,40,2,6,36,307,0.5714285714285714,0.7407201651805968,"(37.5, 52.0]",Q3
36011,2020-04-03,77145,40,1,7,15,322,0.7142857142857143,0.925900206475746,"(37.5, 52.0]",Q3
36011,2020-04-04,77145,40,1,8,32,354,0.8571428571428571,1.1110802477708952,"(37.5, 52.0]",Q3
36011,2020-04-05,77145,40,3,11,31,385,1.1428571428571428,1.4814403303611936,"(37.5, 52.0]",Q3
36011,2020-04-06,77145,40,3,14,33,418,1.5714285714285714,2.036980454246641,"(37.5, 52.0]",Q3
36011,2020-04-07,77145,40,0,14,11,429,1.5714285714285714,2.036980454246641,"(37.5, 52.0]",Q3
36011,2020-04-08,77145,40,2,16,37,466,1.7142857142857142,2.2221604955417904,"(37.5, 52.0]",Q3
36011,2020-04-09,77145,40,11,27,31,497,3.0,3.8887808671981334,"(37.5, 52.0]",Q3
36011,2020-04-10,77145,40,1,28,5,502,3.0,3.8887808671981334,"(37.5, 52.0]",Q3
36011,2020-04-11,77145,40,1,29,8,510,3.0,3.8887808671981334,"(37.5, 52.0]",Q3
36011,2020-04-12,77145,40,1,30,5,515,2.7142857142857144,3.518420784607835,"(37.5, 52.0]",Q3
36011,2020-04-13,77145,40,3,33,52,567,2.7142857142857144,3.518420784607835,"(37.5, 52.0]",Q3
36011,2020-04-14,77145,40,3,36,10,577,3.142857142857143,4.073960908493282,"(37.5, 52.0]",Q3
36011,2020-04-15,77145,40,0,36,10,587,2.857142857142857,3.703600825902984,"(37.5, 52.0]",Q3
36011,2020-04-16,77145,40,0,36,1,588,1.2857142857142858,1.666620371656343,"(37.5, 52.0]",Q3
36011,2020-04-17,77145,40,0,36,9,597,1.1428571428571428,1.4814403303611936,"(37.5, 52.0]",Q3
36011,2020-04-18,77145,40,0,36,9,606,1.0,1.2962602890660446,"(37.5, 52.0]",Q3
36011,2020-04-19,77145,40,0,36,12,618,0.8571428571428571,1.1110802477708952,"(37.5, 52.0]",Q3
36011,2020-04-20,77145,40,0,36,1,619,0.42857142857142855,0.5555401238854476,"(37.5, 52.0]",Q3
36011,2020-04-21,77145,40,0,36,3,622,0.0,0.0,"(37.5, 52.0]",Q3
36011,2020-04-22,77145,40,1,37,12,634,0.14285714285714285,0.1851800412951492,"(37.5, 52.0]",Q3
36011,2020-04-23,77145,40,2,39,14,648,0.42857142857142855,0.5555401238854476,"(37.5, 52.0]",Q3
36011,2020-04-24,77145,40,8,47,191,839,1.5714285714285714,2.036980454246641,"(37.5, 52.0]",Q3
36011,2020-04-25,77145,40,0,47,19,858,1.5714285714285714,2.036980454246641,"(37.5, 52.0]",Q3
36011,2020-04-26,77145,40,1,48,20,878,1.7142857142857142,2.2221604955417904,"(37.5, 52.0]",Q3
36011,2020-04-27,77145,40,0,48,20,898,1.7142857142857142,2.2221604955417904,"(37.5, 52.0]",Q3
36011,2020-04-28,77145,40,0,48,34,932,1.7142857142857142,2.2221604955417904,"(37.5, 52.0]",Q3
36011,2020-04-29,77145,40,0,48,25,957,1.5714285714285714,2.036980454246641,"(37.5, 52.0]",Q3
36011,2020-04-30,77145,40,3,51,28,985,1.7142857142857142,2.2221604955417904,"(37.5, 52.0]",Q3
36011,2020-05-01,77145,40,0,51,17,1002,0.5714285714285714,0.7407201651805968,"(37.5, 52.0]",Q3
36011,2020-05-02,77145,40,0,51,14,1016,0.5714285714285714,0.7407201651805968,"(37.5, 52.0]",Q3
36011,2020-05-03,77145,40,0,51,10,1026,0.42857142857142855,0.5555401238854476,"(37.5, 52.0]",Q3
36011,2020-05-04,77145,40,0,51,22,1048,0.42857142857142855,0.5555401238854476,"(37.5, 52.0]",Q3
36011,2020-05-05,77145,40,0,51,19,1067,0.42857142857142855,0.5555401238854476,"(37.5, 52.0]",Q3
36011,2020-05-06,77145,40,1,52,25,1092,0.5714285714285714,0.7407201651805968,"(37.5, 52.0]",Q3
36011,2020-05-07,77145,40,0,52,20,1112,0.14285714285714285,0.1851800412951492,"(37.5, 52.0]",Q3
36011,2020-05-08,77145,40,1,53,61,1173,0.2857142857142857,0.3703600825902984,"(37.5, 52.0]",Q3
36011,2020-05-09,77145,40,5,58,23,1196,1.0,1.2962602890660446,"(37.5, 52.0]",Q3
36011,2020-05-10,77145,40,2,60,48,1244,1.2857142857142858,1.666620371656343,"(37.5, 52.0]",Q3
36011,2020-05-11,77145,40,0,60,23,1267,1.2857142857142858,1.666620371656343,"(37.5, 52.0]",Q3
36011,2020-05-12,77145,40,0,60,45,1312,1.2857142857142858,1.666620371656343,"(37.5, 52.0]",Q3
36011,2020-05-13,77145,40,0,60,104,1416,1.1428571428571428,1.4814403303611936,"(37.5, 52.0]",Q3
36011,2020-05-14,77145,40,1,61,261,1677,1.2857142857142858,1.666620371656343,"(37.5, 52.0]",Q3
36011,2020-05-15,77145,40,2,63,111,1788,1.4285714285714286,1.851800412951492,"(37.5, 52.0]",Q3
36011,2020-05-16,77145,40,0,63,79,1867,0.7142857142857143,0.925900206475746,"(37.5, 52.0]",Q3
36011,2020-05-17,77145,40,2,65,189,2056,0.7142857142857143,0.925900206475746,"(37.5, 52.0]",Q3
36011,2020-05-18,77145,40,3,68,68,2124,1.1428571428571428,1.4814403303611936,"(37.5, 52.0]",Q3
36011,2020-05-19,77145,40,0,68,106,2230,1.1428571428571428,1.4814403303611936,"(37.5, 52.0]",Q3
36011,2020-05-20,77145,40,4,72,105,2335,1.7142857142857142,2.2221604955417904,"(37.5, 52.0]",Q3
36011,2020-05-21,77145,40,1,73,245,2580,1.7142857142857142,2.2221604955417904,"(37.5, 52.0]",Q3
36011,2020-05-22,77145,40,3,76,356,2936,1.8571428571428572,2.40734053683694,"(37.5, 52.0]",Q3
36011,2020-05-23,77145,40,1,77,143,3079,2.0,2.5925205781320892,"(37.5, 52.0]",Q3
36011,2020-05-24,77145,40,0,77,176,3255,1.7142857142857142,2.2221604955417904,"(37.5, 52.0]",Q3
36011,2020-05-25,77145,40,1,78,76,3331,1.4285714285714286,1.851800412951492,"(37.5, 52.0]",Q3
36011,2020-05-26,77145,40,2,80,117,3448,1.7142857142857142,2.2221604955417904,"(37.5, 52.0]",Q3
36011,2020-05-27,77145,40,4,84,101,3549,1.7142857142857142,2.2221604955417904,"(37.5, 52.0]",Q3
36011,2020-05-28,77145,40,5,89,383,3932,2.2857142857142856,2.962880660722387,"(37.5, 52.0]",Q3
36011,2020-05-29,77145,40,1,90,374,4306,2.0,2.5925205781320892,"(37.5, 52.0]",Q3
36011,2020-05-30,77145,40,1,91,249,4555,2.0,2.5925205781320892,"(37.5, 52.0]",Q3
36011,2020-05-31,77145,40,1,92,289,4844,2.142857142857143,2.7777006194272382,"(37.5, 52.0]",Q3
36011,2020-06-01,77145,40,1,93,250,5094,2.142857142857143,2.7777006194272382,"(37.5, 52.0]",Q3
36011,2020-06-02,77145,40,3,96,288,5382,2.2857142857142856,2.962880660722387,"(37.5, 52.0]",Q3
36011,2020-06-03,77145,40,0,96,375,5757,1.7142857142857142,2.2221604955417904,"(37.5, 52.0]",Q3
36011,2020-06-04,77145,40,2,98,375,6132,1.2857142857142858,1.666620371656343,"(37.5, 52.0]",Q3
36011,2020-06-05,77145,40,2,100,299,6431,1.4285714285714286,1.851800412951492,"(37.5, 52.0]",Q3
36011,2020-06-06,77145,40,1,101,233,6664,1.4285714285714286,1.851800412951492,"(37.5, 52.0]",Q3
36011,2020-06-07,77145,40,0,101,465,7129,1.2857142857142858,1.666620371656343,"(37.5, 52.0]",Q3
36013,2020-03-02,127939,53,0,0,0,0,0.0,0.0,"(52.0, 100.0]",Q4
36013,2020-03-03,127939,53,0,0,0,0,0.0,0.0,"(52.0, 100.0]",Q4
36013,2020-03-04,127939,53,0,0,0,0,0.0,0.0,"(52.0, 100.0]",Q4
36013,2020-03-05,127939,53,0,0,0,0,0.0,0.0,"(52.0, 100.0]",Q4
36013,2020-03-06,127939,53,0,0,0,0,0.0,0.0,"(52.0, 100.0]",Q4
36013,2020-03-07,127939,53,0,0,0,0,0.0,0.0,"(52.0, 100.0]",Q4
36013,2020-03-08,127939,53,0,0,0,0,0.0,0.0,"(52.0, 100.0]",Q4
36013,2020-03-09,127939,53,0,0,0,0,0.0,0.0,"(52.0, 100.0]",Q4
36013,2020-03-10,127939,53,0,0,0,0,0.0,0.0,"(52.0, 100.0]",Q4
36013,2020-03-11,127939,53,0,0,0,0,0.0,0.0,"(52.0, 100.0]",Q4
36013,2020-03-12,127939,53,0,0,1,1,0.0,0.0,"(52.0, 100.0]",Q4
36013,2020-03-13,127939,53,0,0,1,2,0.0,0.0,"(52.0, 100.0]",Q4
36013,2020-03-14,127939,53,0,0,0,2,0.0,0.0,"(52.0, 100.0]",Q4
36013,2020-03-15,127939,53,0,0,1,3,0.0,0.0,"(52.0, 100.0]",Q4
36013,2020-03-16,127939,53,0,0,0,3,0.0,0.0,"(52.0, 100.0]",Q4
36013,2020-03-17,127939,53,0,0,0,3,0.0,0.0,"(52.0, 100.0]",Q4
36013,2020-03-18,127939,53,0,0,3,6,0.0,0.0,"(52.0, 100.0]",Q4
36013,2020-03-19,127939,53,0,0,1,7,0.0,0.0,"(52.0, 100.0]",Q4
36013,2020-03-20,127939,53,0,0,2,9,0.0,0.0,"(52.0, 100.0]",Q4
36013,2020-03-21,127939,53,0,0,4,13,0.0,0.0,"(52.0, 100.0]",Q4
36013,2020-03-22,127939,53,0,0,12,25,0.0,0.0,"(52.0, 100.0]",Q4
36013,2020-03-23,127939,53,0,0,4,29,0.0,0.0,"(52.0, 100.0]",Q4
36013,2020-03-24,127939,53,1,1,3,32,0.14285714285714285,0.11166035599554698,"(52.0, 100.0]",Q4
36013,2020-03-25,127939,53,0,1,4,36,0.14285714285714285,0.11166035599554698,"(52.0, 100.0]",Q4
36013,2020-03-26,127939,53,0,1,20,56,0.14285714285714285,0.11166035599554698,"(52.0, 100.0]",Q4
36013,2020-03-27,127939,53,4,5,19,75,0.7142857142857143,0.558301779977735,"(52.0, 100.0]",Q4
36013,2020-03-28,127939,53,0,5,20,95,0.7142857142857143,0.558301779977735,"(52.0, 100.0]",Q4
36013,2020-03-29,127939,53,0,5,3,98,0.7142857142857143,0.558301779977735,"(52.0, 100.0]",Q4
36013,2020-03-30,127939,53,1,6,9,107,0.8571428571428571,0.6699621359732818,"(52.0, 100.0]",Q4
36013,2020-03-31,127939,53,0,6,9,116,0.7142857142857143,0.558301779977735,"(52.0, 100.0]",Q4
36013,2020-04-01,127939,53,2,8,8,124,1.0,0.7816224919688289,"(52.0, 100.0]",Q4
36013,2020-04-02,127939,53,1,9,15,139,1.1428571428571428,0.8932828479643758,"(52.0, 100.0]",Q4
36013,2020-04-03,127939,53,1,10,20,159,0.7142857142857143,0.558301779977735,"(52.0, 100.0]",Q4
36013,2020-04-04,127939,53,1,11,28,187,0.8571428571428571,0.6699621359732818,"(52.0, 100.0]",Q4
36013,2020-04-05,127939,53,4,15,50,237,1.4285714285714286,1.11660355995547,"(52.0, 100.0]",Q4
36013,2020-04-06,127939,53,1,16,37,274,1.4285714285714286,1.11660355995547,"(52.0, 100.0]",Q4
36013,2020-04-07,127939,53,1,17,6,280,1.5714285714285714,1.228263915951017,"(52.0, 100.0]",Q4
36013,2020-04-08,127939,53,1,18,32,312,1.4285714285714286,1.11660355995547,"(52.0, 100.0]",Q4
36013,2020-04-09,127939,53,2,20,54,366,1.5714285714285714,1.228263915951017,"(52.0, 100.0]",Q4
36013,2020-04-10,127939,53,1,21,67,433,1.5714285714285714,1.228263915951017,"(52.0, 100.0]",Q4
36013,2020-04-11,127939,53,1,22,39,472,1.5714285714285714,1.228263915951017,"(52.0, 100.0]",Q4
36013,2020-04-12,127939,53,1,23,25,497,1.1428571428571428,0.8932828479643758,"(52.0, 100.0]",Q4
36013,2020-04-13,127939,53,0,23,8,505,1.0,0.7816224919688289,"(52.0, 100.0]",Q4
36013,2020-04-14,127939,53,1,24,19,524,1.0,0.7816224919688289,"(52.0, 100.0]",Q4
36013,2020-04-15,127939,53,0,24,29,553,0.8571428571428571,0.6699621359732818,"(52.0, 100.0]",Q4
36013,2020-04-16,127939,53,1,25,32,585,0.7142857142857143,0.558301779977735,"(52.0, 100.0]",Q4
36013,2020-04-17,127939,53,0,25,22,607,0.5714285714285714,0.4466414239821879,"(52.0, 100.0]",Q4
36013,2020-04-18,127939,53,0,25,20,627,0.42857142857142855,0.3349810679866409,"(52.0, 100.0]",Q4
36013,2020-04-19,127939,53,0,25,9,636,0.2857142857142857,0.22332071199109396,"(52.0, 100.0]",Q4
36013,2020-04-20,127939,53,0,25,3,639,0.2857142857142857,0.22332071199109396,"(52.0, 100.0]",Q4
36013,2020-04-21,127939,53,1,26,26,665,0.2857142857142857,0.22332071199109396,"(52.0, 100.0]",Q4
36013,2020-04-22,127939,53,0,26,38,703,0.2857142857142857,0.22332071199109396,"(52.0, 100.0]",Q4
36013,2020-04-23,127939,53,1,27,74,777,0.2857142857142857,0.22332071199109396,"(52.0, 100.0]",Q4
36013,2020-04-24,127939,53,0,27,97,874,0.2857142857142857,0.22332071199109396,"(52.0, 100.0]",Q4
36013,2020-04-25,127939,53,2,29,56,930,0.5714285714285714,0.4466414239821879,"(52.0, 100.0]",Q4
36013,2020-04-26,127939,53,1,30,101,1031,0.7142857142857143,0.558301779977735,"(52.0, 100.0]",Q4
36013,2020-04-27,127939,53,0,30,26,1057,0.7142857142857143,0.558301779977735,"(52.0, 100.0]",Q4
36013,2020-04-28,127939,53,1,31,64,1121,0.7142857142857143,0.558301779977735,"(52.0, 100.0]",Q4
36013,2020-04-29,127939,53,2,33,39,1160,1.0,0.7816224919688289,"(52.0, 100.0]",Q4
36013,2020-04-30,127939,53,2,35,47,1207,1.1428571428571428,0.8932828479643758,"(52.0, 100.0]",Q4
36013,2020-05-01,127939,53,0,35,53,1260,1.1428571428571428,0.8932828479643758,"(52.0, 100.0]",Q4
36013,2020-05-02,127939,53,1,36,18,1278,1.0,0.7816224919688289,"(52.0, 100.0]",Q4
36013,2020-05-03,127939,53,1,37,9,1287,1.0,0.7816224919688289,"(52.0, 100.0]",Q4
36013,2020-05-04,127939,53,0,37,54,1341,1.0,0.7816224919688289,"(52.0, 100.0]",Q4
36013,2020-05-05,127939,53,1,38,88,1429,1.0,0.7816224919688289,"(52.0, 100.0]",Q4
36013,2020-05-06,127939,53,2,40,80,1509,1.0,0.7816224919688289,"(52.0, 100.0]",Q4
36013,2020-05-07,127939,53,0,40,51,1560,0.7142857142857143,0.558301779977735,"(52.0, 100.0]",Q4
36013,2020-05-08,127939,53,0,40,97,1657,0.7142857142857143,0.558301779977735,"(52.0, 100.0]",Q4
36013,2020-05-09,127939,53,1,41,58,1715,0.7142857142857143,0.558301779977735,"(52.0, 100.0]",Q4
36013,2020-05-10,127939,53,0,41,27,1742,0.5714285714285714,0.4466414239821879,"(52.0, 100.0]",Q4
36013,2020-05-11,127939,53,1,42,49,1791,0.7142857142857143,0.558301779977735,"(52.0, 100.0]",Q4
36013,2020-05-12,127939,53,1,43,125,1916,0.7142857142857143,0.558301779977735,"(52.0, 100.0]",Q4
36013,2020-05-13,127939,53,1,44,125,2041,0.5714285714285714,0.4466414239821879,"(52.0, 100.0]",Q4
36013,2020-05-14,127939,53,1,45,139,2180,0.7142857142857143,0.558301779977735,"(52.0, 100.0]",Q4
36013,2020-05-15,127939,53,3,48,60,2240,1.1428571428571428,0.8932828479643758,"(52.0, 100.0]",Q4
36013,2020-05-16,127939,53,0,48,91,2331,1.0,0.7816224919688289,"(52.0, 100.0]",Q4
36013,2020-05-17,127939,53,1,49,63,2394,1.1428571428571428,0.8932828479643758,"(52.0, 100.0]",Q4
36013,2020-05-18,127939,53,0,49,98,2492,1.0,0.7816224919688289,"(52.0, 100.0]",Q4
36013,2020-05-19,127939,53,1,50,90,2582,1.0,0.7816224919688289,"(52.0, 100.0]",Q4
36013,2020-05-20,127939,53,8,58,273,2855,2.0,1.5632449839376579,"(52.0, 100.0]",Q4
36013,2020-05-21,127939,53,5,63,190,3045,2.5714285714285716,2.0098864079198457,"(52.0, 100.0]",Q4
36013,2020-05-22,127939,53,9,72,217,3262,3.4285714285714284,2.679848543893127,"(52.0, 100.0]",Q4
36013,2020-05-23,127939,53,3,75,134,3396,3.857142857142857,3.0148296118797684,"(52.0, 100.0]",Q4
36013,2020-05-24,127939,53,0,75,38,3434,3.7142857142857144,2.903169255884222,"(52.0, 100.0]",Q4
36013,2020-05-25,127939,53,2,77,94,3528,4.0,3.1264899678753157,"(52.0, 100.0]",Q4
36013,2020-05-26,127939,53,1,78,145,3673,4.0,3.1264899678753157,"(52.0, 100.0]",Q4
36013,2020-05-27,127939,53,3,81,129,3802,3.2857142857142856,2.5681881878975807,"(52.0, 100.0]",Q4
36013,2020-05-28,127939,53,1,82,637,4439,2.7142857142857144,2.1215467639153927,"(52.0, 100.0]",Q4
36013,2020-05-29,127939,53,1,83,272,4711,1.5714285714285714,1.228263915951017,"(52.0, 100.0]",Q4
36013,2020-05-30,127939,53,1,84,637,5348,1.2857142857142858,1.0049432039599229,"(52.0, 100.0]",Q4
36013,2020-05-31,127939,53,1,85,253,5601,1.4285714285714286,1.11660355995547,"(52.0, 100.0]",Q4
36013,2020-06-01,127939,53,1,86,184,5785,1.2857142857142858,1.0049432039599229,"(52.0, 100.0]",Q4
36013,2020-06-02,127939,53,3,89,277,6062,1.5714285714285714,1.228263915951017,"(52.0, 100.0]",Q4
36013,2020-06-03,127939,53,6,95,604,6666,2.0,1.5632449839376579,"(52.0, 100.0]",Q4
36013,2020-06-04,127939,53,2,97,522,7188,2.142857142857143,1.6749053399332046,"(52.0, 100.0]",Q4
36013,2020-06-05,127939,53,2,99,364,7552,2.2857142857142856,1.7865656959287517,"(52.0, 100.0]",Q4
36013,2020-06-06,127939,53,2,101,1131,8683,2.4285714285714284,1.8982260519242988,"(52.0, 100.0]",Q4
36013,2020-06-07,127939,53,0,101,343,9026,2.2857142857142856,1.7865656959287517,"(52.0, 100.0]",Q4
36015,2020-03-02,84254,38,0,0,0,0,0.0,0.0,"(37.5, 52.0]",Q3
36015,2020-03-03,84254,38,0,0,0,0,0.0,0.0,"(37.5, 52.0]",Q3
36015,2020-03-04,84254,38,0,0,0,0,0.0,0.0,"(37.5, 52.0]",Q3
36015,2020-03-05,84254,38,0,0,0,0,0.0,0.0,"(37.5, 52.0]",Q3
36015,2020-03-06,84254,38,0,0,0,0,0.0,0.0,"(37.5, 52.0]",Q3
36015,2020-03-07,84254,38,0,0,0,0,0.0,0.0,"(37.5, 52.0]",Q3
36015,2020-03-08,84254,38,0,0,0,0,0.0,0.0,"(37.5, 52.0]",Q3
36015,2020-03-09,84254,38,0,0,0,0,0.0,0.0,"(37.5, 52.0]",Q3
36015,2020-03-10,84254,38,0,0,1,1,0.0,0.0,"(37.5, 52.0]",Q3
36015,2020-03-11,84254,38,0,0,0,1,0.0,0.0,"(37.5, 52.0]",Q3
36015,2020-03-12,84254,38,0,0,0,1,0.0,0.0,"(37.5, 52.0]",Q3
36015,2020-03-13,84254,38,0,0,0,1,0.0,0.0,"(37.5, 52.0]",Q3
36015,2020-03-14,84254,38,0,0,0,1,0.0,0.0,"(37.5, 52.0]",Q3
36015,2020-03-15,84254,38,0,0,1,2,0.0,0.0,"(37.5, 52.0]",Q3
36015,2020-03-16,84254,38,0,0,0,2,0.0,0.0,"(37.5, 52.0]",Q3
36015,2020-03-17,84254,38,0,0,0,2,0.0,0.0,"(37.5, 52.0]",Q3
36015,2020-03-18,84254,38,0,0,2,4,0.0,0.0,"(37.5, 52.0]",Q3
36015,2020-03-19,84254,38,0,0,6,10,0.0,0.0,"(37.5, 52.0]",Q3
36015,2020-03-20,84254,38,0,0,10,20,0.0,0.0,"(37.5, 52.0]",Q3
36015,2020-03-21,84254,38,0,0,2,22,0.0,0.0,"(37.5, 52.0]",Q3
36015,2020-03-22,84254,38,0,0,17,39,0.0,0.0,"(37.5, 52.0]",Q3
36015,2020-03-23,84254,38,1,1,17,56,0.14285714285714285,0.1695553242067354,"(37.5, 52.0]",Q3
36015,2020-03-24,84254,38,0,1,5,61,0.14285714285714285,0.1695553242067354,"(37.5, 52.0]",Q3
36015,2020-03-25,84254,38,6,7,57,118,1.0,1.186887269447148,"(37.5, 52.0]",Q3
36015,2020-03-26,84254,38,4,11,48,166,1.5714285714285714,1.8651085662740896,"(37.5, 52.0]",Q3
36015,2020-03-27,84254,38,1,12,48,214,1.7142857142857142,2.0346638904808247,"(37.5, 52.0]",Q3
36015,2020-03-28,84254,38,3,15,25,239,2.142857142857143,2.543329863101031,"(37.5, 52.0]",Q3
36015,2020-03-29,84254,38,0,15,7,246,2.142857142857143,2.543329863101031,"(37.5, 52.0]",Q3
36015,2020-03-30,84254,38,5,20,47,293,2.7142857142857144,3.2215511599279734,"(37.5, 52.0]",Q3
36015,2020-03-31,84254,38,2,22,42,335,3.0,3.5606618083414436,"(37.5, 52.0]",Q3
36015,2020-04-01,84254,38,0,22,14,349,2.142857142857143,2.543329863101031,"(37.5, 52.0]",Q3
36015,2020-04-02,84254,38,13,35,84,433,3.4285714285714284,4.0693277809616495,"(37.5, 52.0]",Q3
36015,2020-04-03,84254,38,1,36,28,461,3.4285714285714284,4.0693277809616495,"(37.5, 52.0]",Q3
36015,2020-04-04,84254,38,2,38,35,496,3.2857142857142856,3.899772456754914,"(37.5, 52.0]",Q3
36015,2020-04-05,84254,38,9,47,50,546,4.571428571428571,5.425770374615533,"(37.5, 52.0]",Q3
36015,2020-04-06,84254,38,2,49,22,568,4.142857142857143,4.917104401995328,"(37.5, 52.0]",Q3
36015,2020-04-07,84254,38,6,55,56,624,4.714285714285714,5.595325698822268,"(37.5, 52.0]",Q3
36015,2020-04-08,84254,38,4,59,38,662,5.285714285714286,6.27354699564921,"(37.5, 52.0]",Q3
36015,2020-04-09,84254,38,0,59,39,701,3.4285714285714284,4.0693277809616495,"(37.5, 52.0]",Q3
36015,2020-04-10,84254,38,1,60,26,727,3.4285714285714284,4.0693277809616495,"(37.5, 52.0]",Q3
36015,2020-04-11,84254,38,0,60,6,733,3.142857142857143,3.730217132548179,"(37.5, 52.0]",Q3
36015,2020-04-12,84254,38,0,60,9,742,1.8571428571428572,2.2042192146875608,"(37.5, 52.0]",Q3
36015,2020-04-13,84254,38,4,64,40,782,2.142857142857143,2.543329863101031,"(37.5, 52.0]",Q3
36015,2020-04-14,84254,38,5,69,43,825,2.0,2.373774538894296,"(37.5, 52.0]",Q3
36015,2020-04-15,84254,38,1,70,18,843,1.5714285714285714,1.8651085662740896,"(37.5, 52.0]",Q3
36015,2020-04-16,84254,38,1,71,9,852,1.7142857142857142,2.0346638904808247,"(37.5, 52.0]",Q3
36015,2020-04-17,84254,38,1,72,32,884,1.7142857142857142,2.0346638904808247,"(37.5, 52.0]",Q3
36015,2020-04-18,84254,38,1,73,15,899,1.8571428571428572,2.2042192146875608,"(37.5, 52.0]",Q3
36015,2020-04-19,84254,38,0,73,17,916,1.8571428571428572,2.2042192146875608,"(37.5, 52.0]",Q3
36015,2020-04-20,84254,38,2,75,32,948,1.5714285714285714,1.8651085662740896,"(37.5, 52.0]",Q3
36015,2020-04-21,84254,38,0,75,38,986,0.8571428571428571,1.0173319452404124,"(37.5, 52.0]",Q3
36015,2020-04-22,84254,38,1,76,29,1015,0.8571428571428571,1.0173319452404124,"(37.5, 52.0]",Q3
36015,2020-04-23,84254,38,3,79,39,1054,1.1428571428571428,1.3564425936538833,"(37.5, 52.0]",Q3
36015,2020-04-24,84254,38,24,103,228,1282,4.428571428571429,5.256215050408798,"(37.5, 52.0]",Q3
36015,2020-04-25,84254,38,3,106,17,1299,4.714285714285714,5.595325698822268,"(37.5, 52.0]",Q3
36015,2020-04-26,84254,38,2,108,20,1319,5.0,5.9344363472357395,"(37.5, 52.0]",Q3
36015,2020-04-27,84254,38,5,113,64,1383,5.428571428571429,6.443102319855947,"(37.5, 52.0]",Q3
36015,2020-04-28,84254,38,6,119,96,1479,6.285714285714286,7.460434265096358,"(37.5, 52.0]",Q3
36015,2020-04-29,84254,38,3,122,84,1563,6.571428571428571,7.799544913509828,"(37.5, 52.0]",Q3
36015,2020-04-30,84254,38,1,123,54,1617,6.285714285714286,7.460434265096358,"(37.5, 52.0]",Q3
36015,2020-05-01,84254,38,1,124,36,1653,3.0,3.5606618083414436,"(37.5, 52.0]",Q3
36015,2020-05-02,84254,38,1,125,26,1679,2.7142857142857144,3.2215511599279734,"(37.5, 52.0]",Q3
36015,2020-05-03,84254,38,1,126,244,1923,2.5714285714285716,3.051995835721238,"(37.5, 52.0]",Q3
36015,2020-05-04,84254,38,0,126,154,2077,1.8571428571428572,2.2042192146875608,"(37.5, 52.0]",Q3
36015,2020-05-05,84254,38,2,128,143,2220,1.2857142857142858,1.525997917860619,"(37.5, 52.0]",Q3
36015,2020-05-06,84254,38,1,129,89,2309,1.0,1.186887269447148,"(37.5, 52.0]",Q3
36015,2020-05-07,84254,38,1,130,46,2355,1.0,1.186887269447148,"(37.5, 52.0]",Q3
36015,2020-05-08,84254,38,1,131,108,2463,1.0,1.186887269447148,"(37.5, 52.0]",Q3
36015,2020-05-09,84254,38,0,131,125,2588,0.8571428571428571,1.0173319452404124,"(37.5, 52.0]",Q3
36015,2020-05-10,84254,38,0,131,174,2762,0.7142857142857143,0.847776621033677,"(37.5, 52.0]",Q3
36015,2020-05-11,84254,38,0,131,68,2830,0.7142857142857143,0.847776621033677,"(37.5, 52.0]",Q3
36015,2020-05-12,84254,38,1,132,282,3112,0.5714285714285714,0.6782212968269417,"(37.5, 52.0]",Q3
36015,2020-05-13,84254,38,0,132,312,3424,0.42857142857142855,0.5086659726202062,"(37.5, 52.0]",Q3
36015,2020-05-14,84254,38,1,133,234,3658,0.42857142857142855,0.5086659726202062,"(37.5, 52.0]",Q3
36015,2020-05-15,84254,38,1,134,240,3898,0.42857142857142855,0.5086659726202062,"(37.5, 52.0]",Q3
36015,2020-05-16,84254,38,0,134,106,4004,0.42857142857142855,0.5086659726202062,"(37.5, 52.0]",Q3
36015,2020-05-17,84254,38,0,134,68,4072,0.42857142857142855,0.5086659726202062,"(37.5, 52.0]",Q3
36015,2020-05-18,84254,38,0,134,118,4190,0.42857142857142855,0.5086659726202062,"(37.5, 52.0]",Q3
36015,2020-05-19,84254,38,0,134,113,4303,0.2857142857142857,0.3391106484134708,"(37.5, 52.0]",Q3
36015,2020-05-20,84254,38,0,134,91,4394,0.2857142857142857,0.3391106484134708,"(37.5, 52.0]",Q3
36015,2020-05-21,84254,38,1,135,141,4535,0.2857142857142857,0.3391106484134708,"(37.5, 52.0]",Q3
36015,2020-05-22,84254,38,1,136,233,4768,0.2857142857142857,0.3391106484134708,"(37.5, 52.0]",Q3
36015,2020-05-23,84254,38,0,136,215,4983,0.2857142857142857,0.3391106484134708,"(37.5, 52.0]",Q3
36015,2020-05-24,84254,38,0,136,196,5179,0.2857142857142857,0.3391106484134708,"(37.5, 52.0]",Q3
36015,2020-05-25,84254,38,0,136,96,5275,0.2857142857142857,0.3391106484134708,"(37.5, 52.0]",Q3
36015,2020-05-26,84254,38,0,136,295,5570,0.2857142857142857,0.3391106484134708,"(37.5, 52.0]",Q3
36015,2020-05-27,84254,38,0,136,63,5633,0.2857142857142857,0.3391106484134708,"(37.5, 52.0]",Q3
36015,2020-05-28,84254,38,1,137,99,5732,0.2857142857142857,0.3391106484134708,"(37.5, 52.0]",Q3
36015,2020-05-29,84254,38,0,137,451,6183,0.14285714285714285,0.1695553242067354,"(37.5, 52.0]",Q3
36015,2020-05-30,84254,38,0,137,337,6520,0.14285714285714285,0.1695553242067354,"(37.5, 52.0]",Q3
36015,2020-05-31,84254,38,0,137,73,6593,0.14285714285714285,0.1695553242067354,"(37.5, 52.0]",Q3
36015,2020-06-01,84254,38,0,137,145,6738,0.14285714285714285,0.1695553242067354,"(37.5, 52.0]",Q3
36015,2020-06-02,84254,38,0,137,247,6985,0.14285714285714285,0.1695553242067354,"(37.5, 52.0]",Q3
36015,2020-06-03,84254,38,0,137,219,7204,0.14285714285714285,0.1695553242067354,"(37.5, 52.0]",Q3
36015,2020-06-04,84254,38,0,137,114,7318,0.0,0.0,"(37.5, 52.0]",Q3
36015,2020-06-05,84254,38,0,137,853,8171,0.0,0.0,"(37.5, 52.0]",Q3
36015,2020-06-06,84254,38,0,137,263,8434,0.0,0.0,"(37.5, 52.0]",Q3
36015,2020-06-07,84254,38,0,137,217,8651,0.0,0.0,"(37.5, 52.0]",Q3
36017,2020-03-02,47536,36,0,0,0,0,0.0,0.0,"(24.0, 37.5]",Q2
36017,2020-03-03,47536,36,0,0,0,0,0.0,0.0,"(24.0, 37.5]",Q2
36017,2020-03-04,47536,36,0,0,0,0,0.0,0.0,"(24.0, 37.5]",Q2
36017,2020-03-05,47536,36,0,0,0,0,0.0,0.0,"(24.0, 37.5]",Q2
36017,2020-03-06,47536,36,0,0,0,0,0.0,0.0,"(24.0, 37.5]",Q2
36017,2020-03-07,47536,36,0,0,0,0,0.0,0.0,"(24.0, 37.5]",Q2
36017,2020-03-08,47536,36,0,0,0,0,0.0,0.0,"(24.0, 37.5]",Q2
36017,2020-03-09,47536,36,0,0,0,0,0.0,0.0,"(24.0, 37.5]",Q2
36017,2020-03-10,47536,36,0,0,0,0,0.0,0.0,"(24.0, 37.5]",Q2
36017,2020-03-11,47536,36,0,0,0,0,0.0,0.0,"(24.0, 37.5]",Q2
36017,2020-03-12,47536,36,0,0,0,0,0.0,0.0,"(24.0, 37.5]",Q2
36017,2020-03-13,47536,36,0,0,0,0,0.0,0.0,"(24.0, 37.5]",Q2
36017,2020-03-14,47536,36,0,0,0,0,0.0,0.0,"(24.0, 37.5]",Q2
36017,2020-03-15,47536,36,0,0,1,1,0.0,0.0,"(24.0, 37.5]",Q2
36017,2020-03-16,47536,36,0,0,2,3,0.0,0.0,"(24.0, 37.5]",Q2
36017,2020-03-17,47536,36,1,1,1,4,0.14285714285714285,0.30052411405491175,"(24.0, 37.5]",Q2
36017,2020-03-18,47536,36,1,2,1,5,0.2857142857142857,0.6010482281098235,"(24.0, 37.5]",Q2
36017,2020-03-19,47536,36,0,2,0,5,0.2857142857142857,0.6010482281098235,"(24.0, 37.5]",Q2
36017,2020-03-20,47536,36,0,2,4,9,0.2857142857142857,0.6010482281098235,"(24.0, 37.5]",Q2
36017,2020-03-21,47536,36,1,3,4,13,0.42857142857142855,0.9015723421647351,"(24.0, 37.5]",Q2
36017,2020-03-22,47536,36,0,3,2,15,0.42857142857142855,0.9015723421647351,"(24.0, 37.5]",Q2
36017,2020-03-23,47536,36,0,3,3,18,0.42857142857142855,0.9015723421647351,"(24.0, 37.5]",Q2
36017,2020-03-24,47536,36,0,3,6,24,0.2857142857142857,0.6010482281098235,"(24.0, 37.5]",Q2
36017,2020-03-25,47536,36,0,3,1,25,0.14285714285714285,0.30052411405491175,"(24.0, 37.5]",Q2
36017,2020-03-26,47536,36,1,4,6,31,0.2857142857142857,0.6010482281098235,"(24.0, 37.5]",Q2
36017,2020-03-27,47536,36,4,8,13,44,0.8571428571428571,1.8031446843294703,"(24.0, 37.5]",Q2
36017,2020-03-28,47536,36,7,15,15,59,1.7142857142857142,3.6062893686589406,"(24.0, 37.5]",Q2
36017,2020-03-29,47536,36,2,17,7,66,2.0,4.207337596768765,"(24.0, 37.5]",Q2
36017,2020-03-30,47536,36,2,19,9,75,2.2857142857142856,4.808385824878588,"(24.0, 37.5]",Q2
36017,2020-03-31,47536,36,7,26,20,95,3.2857142857142856,6.91205462326297,"(24.0, 37.5]",Q2
36017,2020-04-01,47536,36,2,28,16,111,3.5714285714285716,7.513102851372794,"(24.0, 37.5]",Q2
36017,2020-04-02,47536,36,4,32,17,128,4.0,8.41467519353753,"(24.0, 37.5]",Q2
36017,2020-04-03,47536,36,7,39,40,168,4.428571428571429,9.316247535702265,"(24.0, 37.5]",Q2
36017,2020-04-04,47536,36,4,43,17,185,4.0,8.41467519353753,"(24.0, 37.5]",Q2
36017,2020-04-05,47536,36,3,46,27,212,4.142857142857143,8.715199307592442,"(24.0, 37.5]",Q2
36017,2020-04-06,47536,36,5,51,42,254,4.571428571428571,9.616771649757176,"(24.0, 37.5]",Q2
36017,2020-04-07,47536,36,2,53,11,265,3.857142857142857,8.114151079482617,"(24.0, 37.5]",Q2
36017,2020-04-08,47536,36,2,55,21,286,3.857142857142857,8.114151079482617,"(24.0, 37.5]",Q2
36017,2020-04-09,47536,36,5,60,29,315,4.0,8.41467519353753,"(24.0, 37.5]",Q2
36017,2020-04-10,47536,36,1,61,17,332,3.142857142857143,6.611530509208059,"(24.0, 37.5]",Q2
36017,2020-04-11,47536,36,2,63,12,344,2.857142857142857,6.010482281098235,"(24.0, 37.5]",Q2
36017,2020-04-12,47536,36,2,65,17,361,2.7142857142857144,5.7099581670433235,"(24.0, 37.5]",Q2
36017,2020-04-13,47536,36,3,68,36,397,2.4285714285714284,5.1089099389334995,"(24.0, 37.5]",Q2
36017,2020-04-14,47536,36,3,71,17,414,2.5714285714285716,5.409434052988413,"(24.0, 37.5]",Q2
36017,2020-04-15,47536,36,2,73,21,435,2.5714285714285716,5.409434052988413,"(24.0, 37.5]",Q2
36017,2020-04-16,47536,36,3,76,16,451,2.2857142857142856,4.808385824878588,"(24.0, 37.5]",Q2
36017,2020-04-17,47536,36,1,77,11,462,2.2857142857142856,4.808385824878588,"(24.0, 37.5]",Q2
36017,2020-04-18,47536,36,1,78,13,475,2.142857142857143,4.5078617108236765,"(24.0, 37.5]",Q2
36017,2020-04-19,47536,36,0,78,11,486,1.8571428571428572,3.906813482713853,"(24.0, 37.5]",Q2
36017,2020-04-20,47536,36,1,79,7,493,1.5714285714285714,3.3057652546040295,"(24.0, 37.5]",Q2
36017,2020-04-21,47536,36,0,79,17,510,1.1428571428571428,2.404192912439294,"(24.0, 37.5]",Q2
36017,2020-04-22,47536,36,3,82,20,530,1.2857142857142858,2.7047170264942064,"(24.0, 37.5]",Q2
36017,2020-04-23,47536,36,2,84,20,550,1.1428571428571428,2.404192912439294,"(24.0, 37.5]",Q2
36017,2020-04-24,47536,36,7,91,144,694,2.0,4.207337596768765,"(24.0, 37.5]",Q2
36017,2020-04-25,47536,36,2,93,19,713,2.142857142857143,4.5078617108236765,"(24.0, 37.5]",Q2
36017,2020-04-26,47536,36,2,95,23,736,2.4285714285714284,5.1089099389334995,"(24.0, 37.5]",Q2
36017,2020-04-27,47536,36,0,95,10,746,2.2857142857142856,4.808385824878588,"(24.0, 37.5]",Q2
36017,2020-04-28,47536,36,1,96,18,764,2.4285714285714284,5.1089099389334995,"(24.0, 37.5]",Q2
36017,2020-04-29,47536,36,2,98,25,789,2.2857142857142856,4.808385824878588,"(24.0, 37.5]",Q2
36017,2020-04-30,47536,36,1,99,21,810,2.142857142857143,4.5078617108236765,"(24.0, 37.5]",Q2
36017,2020-05-01,47536,36,0,99,35,845,1.1428571428571428,2.404192912439294,"(24.0, 37.5]",Q2
36017,2020-05-02,47536,36,0,99,36,881,0.8571428571428571,1.8031446843294703,"(24.0, 37.5]",Q2
36017,2020-05-03,47536,36,1,100,50,931,0.7142857142857143,1.5026205702745588,"(24.0, 37.5]",Q2
36017,2020-05-04,47536,36,0,100,42,973,0.7142857142857143,1.5026205702745588,"(24.0, 37.5]",Q2
36017,2020-05-05,47536,36,2,102,51,1024,0.8571428571428571,1.8031446843294703,"(24.0, 37.5]",Q2
36017,2020-05-06,47536,36,3,105,50,1074,1.0,2.1036687983843825,"(24.0, 37.5]",Q2
36017,2020-05-07,47536,36,0,105,26,1100,0.8571428571428571,1.8031446843294703,"(24.0, 37.5]",Q2
36017,2020-05-08,47536,36,4,109,181,1281,1.4285714285714286,3.0052411405491175,"(24.0, 37.5]",Q2
36017,2020-05-09,47536,36,0,109,45,1326,1.4285714285714286,3.0052411405491175,"(24.0, 37.5]",Q2
36017,2020-05-10,47536,36,2,111,107,1433,1.5714285714285714,3.3057652546040295,"(24.0, 37.5]",Q2
36017,2020-05-11,47536,36,1,112,197,1630,1.7142857142857142,3.6062893686589406,"(24.0, 37.5]",Q2
36017,2020-05-12,47536,36,0,112,83,1713,1.4285714285714286,3.0052411405491175,"(24.0, 37.5]",Q2
36017,2020-05-13,47536,36,0,112,41,1754,1.0,2.1036687983843825,"(24.0, 37.5]",Q2
36017,2020-05-14,47536,36,1,113,45,1799,1.1428571428571428,2.404192912439294,"(24.0, 37.5]",Q2
36017,2020-05-15,47536,36,2,115,54,1853,0.8571428571428571,1.8031446843294703,"(24.0, 37.5]",Q2
36017,2020-05-16,47536,36,2,117,50,1903,1.1428571428571428,2.404192912439294,"(24.0, 37.5]",Q2
36017,2020-05-17,47536,36,1,118,62,1965,1.0,2.1036687983843825,"(24.0, 37.5]",Q2
36017,2020-05-18,47536,36,0,118,67,2032,0.8571428571428571,1.8031446843294703,"(24.0, 37.5]",Q2
36017,2020-05-19,47536,36,0,118,54,2086,0.8571428571428571,1.8031446843294703,"(24.0, 37.5]",Q2
36017,2020-05-20,47536,36,0,118,150,2236,0.8571428571428571,1.8031446843294703,"(24.0, 37.5]",Q2
36017,2020-05-21,47536,36,0,118,219,2455,0.7142857142857143,1.5026205702745588,"(24.0, 37.5]",Q2
36017,2020-05-22,47536,36,0,118,143,2598,0.42857142857142855,0.9015723421647351,"(24.0, 37.5]",Q2
36017,2020-05-23,47536,36,0,118,226,2824,0.14285714285714285,0.30052411405491175,"(24.0, 37.5]",Q2
36017,2020-05-24,47536,36,1,119,217,3041,0.14285714285714285,0.30052411405491175,"(24.0, 37.5]",Q2
36017,2020-05-25,47536,36,4,123,221,3262,0.7142857142857143,1.5026205702745588,"(24.0, 37.5]",Q2
36017,2020-05-26,47536,36,2,125,122,3384,1.0,2.1036687983843825,"(24.0, 37.5]",Q2
36017,2020-05-27,47536,36,1,126,139,3523,1.1428571428571428,2.404192912439294,"(24.0, 37.5]",Q2
36017,2020-05-28,47536,36,4,130,168,3691,1.7142857142857142,3.6062893686589406,"(24.0, 37.5]",Q2
36017,2020-05-29,47536,36,2,132,199,3890,2.0,4.207337596768765,"(24.0, 37.5]",Q2
36017,2020-05-30,47536,36,1,133,404,4294,2.142857142857143,4.5078617108236765,"(24.0, 37.5]",Q2
36017,2020-05-31,47536,36,0,133,173,4467,2.0,4.207337596768765,"(24.0, 37.5]",Q2
36017,2020-06-01,47536,36,0,133,190,4657,1.4285714285714286,3.0052411405491175,"(24.0, 37.5]",Q2
36017,2020-06-02,47536,36,0,133,245,4902,1.1428571428571428,2.404192912439294,"(24.0, 37.5]",Q2
36017,2020-06-03,47536,36,0,133,193,5095,1.0,2.1036687983843825,"(24.0, 37.5]",Q2
36017,2020-06-04,47536,36,0,133,329,5424,0.42857142857142855,0.9015723421647351,"(24.0, 37.5]",Q2
36017,2020-06-05,47536,36,0,133,252,5676,0.14285714285714285,0.30052411405491175,"(24.0, 37.5]",Q2
36017,2020-06-06,47536,36,1,134,233,5909,0.14285714285714285,0.30052411405491175,"(24.0, 37.5]",Q2
36017,2020-06-07,47536,36,1,135,313,6222,0.2857142857142857,0.6010482281098235,"(24.0, 37.5]",Q2
36019,2020-03-02,80695,52,0,0,0,0,0.0,0.0,"(37.5, 52.0]",Q3
36019,2020-03-03,80695,52,0,0,0,0,0.0,0.0,"(37.5, 52.0]",Q3
36019,2020-03-04,80695,52,0,0,0,0,0.0,0.0,"(37.5, 52.0]",Q3
36019,2020-03-05,80695,52,0,0,0,0,0.0,0.0,"(37.5, 52.0]",Q3
36019,2020-03-06,80695,52,0,0,0,0,0.0,0.0,"(37.5, 52.0]",Q3
36019,2020-03-07,80695,52,0,0,0,0,0.0,0.0,"(37.5, 52.0]",Q3
36019,2020-03-08,80695,52,0,0,0,0,0.0,0.0,"(37.5, 52.0]",Q3
36019,2020-03-09,80695,52,0,0,0,0,0.0,0.0,"(37.5, 52.0]",Q3
36019,2020-03-10,80695,52,0,0,0,0,0.0,0.0,"(37.5, 52.0]",Q3
36019,2020-03-11,80695,52,0,0,4,4,0.0,0.0,"(37.5, 52.0]",Q3
36019,2020-03-12,80695,52,0,0,3,7,0.0,0.0,"(37.5, 52.0]",Q3
36019,2020-03-13,80695,52,0,0,1,8,0.0,0.0,"(37.5, 52.0]",Q3
36019,2020-03-14,80695,52,0,0,1,9,0.0,0.0,"(37.5, 52.0]",Q3
36019,2020-03-15,80695,52,0,0,0,9,0.0,0.0,"(37.5, 52.0]",Q3
36019,2020-03-16,80695,52,1,1,1,10,0.14285714285714285,0.1770334504704664,"(37.5, 52.0]",Q3
36019,2020-03-17,80695,52,0,1,3,13,0.14285714285714285,0.1770334504704664,"(37.5, 52.0]",Q3
36019,2020-03-18,80695,52,1,2,21,34,0.2857142857142857,0.3540669009409328,"(37.5, 52.0]",Q3
36019,2020-03-19,80695,52,0,2,9,43,0.2857142857142857,0.3540669009409328,"(37.5, 52.0]",Q3
36019,2020-03-20,80695,52,2,4,12,55,0.5714285714285714,0.7081338018818656,"(37.5, 52.0]",Q3
36019,2020-03-21,80695,52,0,4,2,57,0.5714285714285714,0.7081338018818656,"(37.5, 52.0]",Q3
36019,2020-03-22,80695,52,2,6,12,69,0.8571428571428571,1.0622007028227982,"(37.5, 52.0]",Q3
36019,2020-03-23,80695,52,2,8,17,86,1.0,1.2392341532932647,"(37.5, 52.0]",Q3
36019,2020-03-24,80695,52,2,10,14,100,1.2857142857142858,1.5933010542341979,"(37.5, 52.0]",Q3
36019,2020-03-25,80695,52,1,11,16,116,1.2857142857142858,1.5933010542341979,"(37.5, 52.0]",Q3
36019,2020-03-26,80695,52,0,11,6,122,1.2857142857142858,1.5933010542341979,"(37.5, 52.0]",Q3
36019,2020-03-27,80695,52,1,12,22,144,1.1428571428571428,1.4162676037637312,"(37.5, 52.0]",Q3
36019,2020-03-28,80695,52,1,13,18,162,1.2857142857142858,1.5933010542341979,"(37.5, 52.0]",Q3
36019,2020-03-29,80695,52,4,17,19,181,1.5714285714285714,1.9473679551751304,"(37.5, 52.0]",Q3
36019,2020-03-30,80695,52,4,21,9,190,1.8571428571428572,2.301434856116063,"(37.5, 52.0]",Q3
36019,2020-03-31,80695,52,4,25,21,211,2.142857142857143,2.655501757056996,"(37.5, 52.0]",Q3
36019,2020-04-01,80695,52,0,25,5,216,2.0,2.4784683065865294,"(37.5, 52.0]",Q3
36019,2020-04-02,80695,52,5,30,16,232,2.7142857142857144,3.363635558938862,"(37.5, 52.0]",Q3
36019,2020-04-03,80695,52,1,31,11,243,2.7142857142857144,3.363635558938862,"(37.5, 52.0]",Q3
36019,2020-04-04,80695,52,2,33,23,266,2.857142857142857,3.540669009409328,"(37.5, 52.0]",Q3
36019,2020-04-05,80695,52,3,36,14,280,2.7142857142857144,3.363635558938862,"(37.5, 52.0]",Q3
36019,2020-04-06,80695,52,1,37,16,296,2.2857142857142856,2.8325352075274624,"(37.5, 52.0]",Q3
36019,2020-04-07,80695,52,2,39,25,321,2.0,2.4784683065865294,"(37.5, 52.0]",Q3
36019,2020-04-08,80695,52,1,40,25,346,2.142857142857143,2.655501757056996,"(37.5, 52.0]",Q3
36019,2020-04-09,80695,52,3,43,17,363,1.8571428571428572,2.301434856116063,"(37.5, 52.0]",Q3
36019,2020-04-10,80695,52,0,43,23,386,1.7142857142857142,2.1244014056455964,"(37.5, 52.0]",Q3
36019,2020-04-11,80695,52,0,43,25,411,1.4285714285714286,1.770334504704664,"(37.5, 52.0]",Q3
36019,2020-04-12,80695,52,1,44,9,420,1.1428571428571428,1.4162676037637312,"(37.5, 52.0]",Q3
36019,2020-04-13,80695,52,1,45,23,443,1.1428571428571428,1.4162676037637312,"(37.5, 52.0]",Q3
36019,2020-04-14,80695,52,0,45,8,451,0.8571428571428571,1.0622007028227982,"(37.5, 52.0]",Q3
36019,2020-04-15,80695,52,1,46,17,468,0.8571428571428571,1.0622007028227982,"(37.5, 52.0]",Q3
36019,2020-04-16,80695,52,1,47,21,489,0.5714285714285714,0.7081338018818656,"(37.5, 52.0]",Q3
36019,2020-04-17,80695,52,1,48,16,505,0.7142857142857143,0.885167252352332,"(37.5, 52.0]",Q3
36019,2020-04-18,80695,52,1,49,12,517,0.8571428571428571,1.0622007028227982,"(37.5, 52.0]",Q3
36019,2020-04-19,80695,52,2,51,10,527,1.0,1.2392341532932647,"(37.5, 52.0]",Q3
36019,2020-04-20,80695,52,0,51,17,544,0.8571428571428571,1.0622007028227982,"(37.5, 52.0]",Q3
36019,2020-04-21,80695,52,0,51,4,548,0.8571428571428571,1.0622007028227982,"(37.5, 52.0]",Q3
36019,2020-04-22,80695,52,1,52,11,559,0.8571428571428571,1.0622007028227982,"(37.5, 52.0]",Q3
36019,2020-04-23,80695,52,1,53,14,573,0.8571428571428571,1.0622007028227982,"(37.5, 52.0]",Q3
36019,2020-04-24,80695,52,1,54,39,612,0.8571428571428571,1.0622007028227982,"(37.5, 52.0]",Q3
36019,2020-04-25,80695,52,3,57,28,640,1.1428571428571428,1.4162676037637312,"(37.5, 52.0]",Q3
36019,2020-04-26,80695,52,2,59,30,670,1.1428571428571428,1.4162676037637312,"(37.5, 52.0]",Q3
36019,2020-04-27,80695,52,0,59,15,685,1.1428571428571428,1.4162676037637312,"(37.5, 52.0]",Q3
36019,2020-04-28,80695,52,0,59,23,708,1.1428571428571428,1.4162676037637312,"(37.5, 52.0]",Q3
36019,2020-04-29,80695,52,0,59,40,748,1.0,1.2392341532932647,"(37.5, 52.0]",Q3
36019,2020-04-30,80695,52,2,61,48,796,1.1428571428571428,1.4162676037637312,"(37.5, 52.0]",Q3
36019,2020-05-01,80695,52,1,62,35,831,1.1428571428571428,1.4162676037637312,"(37.5, 52.0]",Q3
36019,2020-05-02,80695,52,4,66,33,864,1.2857142857142858,1.5933010542341979,"(37.5, 52.0]",Q3
36019,2020-05-03,80695,52,2,68,21,885,1.2857142857142858,1.5933010542341979,"(37.5, 52.0]",Q3
36019,2020-05-04,80695,52,1,69,27,912,1.4285714285714286,1.770334504704664,"(37.5, 52.0]",Q3
36019,2020-05-05,80695,52,0,69,25,937,1.4285714285714286,1.770334504704664,"(37.5, 52.0]",Q3
36019,2020-05-06,80695,52,0,69,22,959,1.4285714285714286,1.770334504704664,"(37.5, 52.0]",Q3
36019,2020-05-07,80695,52,5,74,72,1031,1.8571428571428572,2.301434856116063,"(37.5, 52.0]",Q3
36019,2020-05-08,80695,52,2,76,27,1058,2.0,2.4784683065865294,"(37.5, 52.0]",Q3
36019,2020-05-09,80695,52,0,76,33,1091,1.4285714285714286,1.770334504704664,"(37.5, 52.0]",Q3
36019,2020-05-10,80695,52,0,76,53,1144,1.1428571428571428,1.4162676037637312,"(37.5, 52.0]",Q3
36019,2020-05-11,80695,52,1,77,38,1182,1.1428571428571428,1.4162676037637312,"(37.5, 52.0]",Q3
36019,2020-05-12,80695,52,1,78,53,1235,1.2857142857142858,1.5933010542341979,"(37.5, 52.0]",Q3
36019,2020-05-13,80695,52,3,81,123,1358,1.7142857142857142,2.1244014056455964,"(37.5, 52.0]",Q3
36019,2020-05-14,80695,52,4,85,126,1484,1.5714285714285714,1.9473679551751304,"(37.5, 52.0]",Q3
36019,2020-05-15,80695,52,6,91,150,1634,2.142857142857143,2.655501757056996,"(37.5, 52.0]",Q3
36019,2020-05-16,80695,52,1,92,88,1722,2.2857142857142856,2.8325352075274624,"(37.5, 52.0]",Q3
36019,2020-05-17,80695,52,2,94,155,1877,2.5714285714285716,3.1866021084683958,"(37.5, 52.0]",Q3
36019,2020-05-18,80695,52,0,94,59,1936,2.4285714285714284,3.0095686579979284,"(37.5, 52.0]",Q3
36019,2020-05-19,80695,52,0,94,58,1994,2.2857142857142856,2.8325352075274624,"(37.5, 52.0]",Q3
36019,2020-05-20,80695,52,0,94,204,2198,1.8571428571428572,2.301434856116063,"(37.5, 52.0]",Q3
36019,2020-05-21,80695,52,0,94,131,2329,1.2857142857142858,1.5933010542341979,"(37.5, 52.0]",Q3
36019,2020-05-22,80695,52,1,95,135,2464,0.5714285714285714,0.7081338018818656,"(37.5, 52.0]",Q3
36019,2020-05-23,80695,52,0,95,131,2595,0.42857142857142855,0.5311003514113991,"(37.5, 52.0]",Q3
36019,2020-05-24,80695,52,0,95,70,2665,0.14285714285714285,0.1770334504704664,"(37.5, 52.0]",Q3
36019,2020-05-25,80695,52,0,95,108,2773,0.14285714285714285,0.1770334504704664,"(37.5, 52.0]",Q3
36019,2020-05-26,80695,52,0,95,51,2824,0.14285714285714285,0.1770334504704664,"(37.5, 52.0]",Q3
36019,2020-05-27,80695,52,0,95,201,3025,0.14285714285714285,0.1770334504704664,"(37.5, 52.0]",Q3
36019,2020-05-28,80695,52,0,95,226,3251,0.14285714285714285,0.1770334504704664,"(37.5, 52.0]",Q3
36019,2020-05-29,80695,52,0,95,441,3692,0.0,0.0,"(37.5, 52.0]",Q3
36019,2020-05-30,80695,52,0,95,329,4021,0.0,0.0,"(37.5, 52.0]",Q3
36019,2020-05-31,80695,52,1,96,146,4167,0.14285714285714285,0.1770334504704664,"(37.5, 52.0]",Q3
36019,2020-06-01,80695,52,1,97,147,4314,0.2857142857142857,0.3540669009409328,"(37.5, 52.0]",Q3
36019,2020-06-02,80695,52,0,97,309,4623,0.2857142857142857,0.3540669009409328,"(37.5, 52.0]",Q3
36019,2020-06-03,80695,52,0,97,632,5255,0.2857142857142857,0.3540669009409328,"(37.5, 52.0]",Q3
36019,2020-06-04,80695,52,0,97,319,5574,0.2857142857142857,0.3540669009409328,"(37.5, 52.0]",Q3
36019,2020-06-05,80695,52,0,97,421,5995,0.2857142857142857,0.3540669009409328,"(37.5, 52.0]",Q3
36019,2020-06-06,80695,52,0,97,305,6300,0.2857142857142857,0.3540669009409328,"(37.5, 52.0]",Q3
36019,2020-06-07,80695,52,0,97,220,6520,0.14285714285714285,0.1770334504704664,"(37.5, 52.0]",Q3
36021,2020-03-02,59916,24,0,0,0,0,0.0,0.0,"(3.999, 24.0]",Q1
36021,2020-03-03,59916,24,0,0,0,0,0.0,0.0,"(3.999, 24.0]",Q1
36021,2020-03-04,59916,24,0,0,0,0,0.0,0.0,"(3.999, 24.0]",Q1
36021,2020-03-05,59916,24,0,0,0,0,0.0,0.0,"(3.999, 24.0]",Q1
36021,2020-03-06,59916,24,0,0,0,0,0.0,0.0,"(3.999, 24.0]",Q1
36021,2020-03-07,59916,24,0,0,0,0,0.0,0.0,"(3.999, 24.0]",Q1
36021,2020-03-08,59916,24,0,0,1,1,0.0,0.0,"(3.999, 24.0]",Q1
36021,2020-03-09,59916,24,0,0,0,1,0.0,0.0,"(3.999, 24.0]",Q1
36021,2020-03-10,59916,24,0,0,0,1,0.0,0.0,"(3.999, 24.0]",Q1
36021,2020-03-11,59916,24,0,0,2,3,0.0,0.0,"(3.999, 24.0]",Q1
36021,2020-03-12,59916,24,0,0,2,5,0.0,0.0,"(3.999, 24.0]",Q1
36021,2020-03-13,59916,24,0,0,1,6,0.0,0.0,"(3.999, 24.0]",Q1
36021,2020-03-14,59916,24,0,0,4,10,0.0,0.0,"(3.999, 24.0]",Q1
36021,2020-03-15,59916,24,0,0,2,12,0.0,0.0,"(3.999, 24.0]",Q1
36021,2020-03-16,59916,24,0,0,13,25,0.0,0.0,"(3.999, 24.0]",Q1
36021,2020-03-17,59916,24,0,0,14,39,0.0,0.0,"(3.999, 24.0]",Q1
36021,2020-03-18,59916,24,0,0,32,71,0.0,0.0,"(3.999, 24.0]",Q1
36021,2020-03-19,59916,24,1,1,24,95,0.14285714285714285,0.23842903874948737,"(3.999, 24.0]",Q1
36021,2020-03-20,59916,24,1,2,35,130,0.2857142857142857,0.47685807749897474,"(3.999, 24.0]",Q1
36021,2020-03-21,59916,24,3,5,52,182,0.7142857142857143,1.1921451937474368,"(3.999, 24.0]",Q1
36021,2020-03-22,59916,24,5,10,48,230,1.4285714285714286,2.3842903874948735,"(3.999, 24.0]",Q1
36021,2020-03-23,59916,24,1,11,10,240,1.5714285714285714,2.622719426244361,"(3.999, 24.0]",Q1
36021,2020-03-24,59916,24,1,12,15,255,1.7142857142857142,2.8611484649938483,"(3.999, 24.0]",Q1
36021,2020-03-25,59916,24,1,13,22,277,1.8571428571428572,3.099577503743336,"(3.999, 24.0]",Q1
36021,2020-03-26,59916,24,7,20,20,297,2.7142857142857144,4.530151736240261,"(3.999, 24.0]",Q1
36021,2020-03-27,59916,24,2,22,15,312,2.857142857142857,4.768580774989747,"(3.999, 24.0]",Q1
36021,2020-03-28,59916,24,1,23,11,323,2.5714285714285716,4.291722697490773,"(3.999, 24.0]",Q1
36021,2020-03-29,59916,24,3,26,26,349,2.2857142857142856,3.814864619991798,"(3.999, 24.0]",Q1
36021,2020-03-30,59916,24,4,30,14,363,2.7142857142857144,4.530151736240261,"(3.999, 24.0]",Q1
36021,2020-03-31,59916,24,1,31,12,375,2.7142857142857144,4.530151736240261,"(3.999, 24.0]",Q1
36021,2020-04-01,59916,24,5,36,21,396,3.2857142857142856,5.4838678912382095,"(3.999, 24.0]",Q1
36021,2020-04-02,59916,24,6,42,22,418,3.142857142857143,5.245438852488722,"(3.999, 24.0]",Q1
36021,2020-04-03,59916,24,7,49,20,438,3.857142857142857,6.437584046236159,"(3.999, 24.0]",Q1
36021,2020-04-04,59916,24,2,51,15,453,4.0,6.676013084985647,"(3.999, 24.0]",Q1
36021,2020-04-05,59916,24,8,59,23,476,4.714285714285714,7.868158278733083,"(3.999, 24.0]",Q1
36021,2020-04-06,59916,24,2,61,15,491,4.428571428571429,7.39130020123411,"(3.999, 24.0]",Q1
36021,2020-04-07,59916,24,2,63,8,499,4.571428571428571,7.629729239983596,"(3.999, 24.0]",Q1
36021,2020-04-08,59916,24,7,70,27,526,4.857142857142857,8.106587317482571,"(3.999, 24.0]",Q1
36021,2020-04-09,59916,24,4,74,55,581,4.571428571428571,7.629729239983596,"(3.999, 24.0]",Q1
36021,2020-04-10,59916,24,3,77,30,611,4.0,6.676013084985647,"(3.999, 24.0]",Q1
36021,2020-04-11,59916,24,2,79,35,646,4.0,6.676013084985647,"(3.999, 24.0]",Q1
36021,2020-04-12,59916,24,1,80,27,673,3.0,5.007009813739235,"(3.999, 24.0]",Q1
36021,2020-04-13,59916,24,4,84,30,703,3.2857142857142856,5.4838678912382095,"(3.999, 24.0]",Q1
36021,2020-04-14,59916,24,12,96,55,758,4.714285714285714,7.868158278733083,"(3.999, 24.0]",Q1
36021,2020-04-15,59916,24,3,99,28,786,4.142857142857143,6.914442123735134,"(3.999, 24.0]",Q1
36021,2020-04-16,59916,24,2,101,20,806,3.857142857142857,6.437584046236159,"(3.999, 24.0]",Q1
36021,2020-04-17,59916,24,4,105,32,838,4.0,6.676013084985647,"(3.999, 24.0]",Q1
36021,2020-04-18,59916,24,2,107,34,872,4.0,6.676013084985647,"(3.999, 24.0]",Q1
36021,2020-04-19,59916,24,4,111,17,889,4.428571428571429,7.39130020123411,"(3.999, 24.0]",Q1
36021,2020-04-20,59916,24,2,113,24,913,4.142857142857143,6.914442123735134,"(3.999, 24.0]",Q1
36021,2020-04-21,59916,24,4,117,34,947,3.0,5.007009813739235,"(3.999, 24.0]",Q1
36021,2020-04-22,59916,24,6,123,35,982,3.4285714285714284,5.722296929987697,"(3.999, 24.0]",Q1
36021,2020-04-23,59916,24,6,129,35,1017,4.0,6.676013084985647,"(3.999, 24.0]",Q1
36021,2020-04-24,59916,24,11,140,105,1122,5.0,8.345016356232058,"(3.999, 24.0]",Q1
36021,2020-04-25,59916,24,3,143,27,1149,5.142857142857143,8.583445394981545,"(3.999, 24.0]",Q1
36021,2020-04-26,59916,24,3,146,22,1171,5.0,8.345016356232058,"(3.999, 24.0]",Q1
36021,2020-04-27,59916,24,8,154,33,1204,5.857142857142857,9.775590588728983,"(3.999, 24.0]",Q1
36021,2020-04-28,59916,24,11,165,37,1241,6.857142857142857,11.444593859975393,"(3.999, 24.0]",Q1
36021,2020-04-29,59916,24,5,170,61,1302,6.714285714285714,11.206164821225906,"(3.999, 24.0]",Q1
36021,2020-04-30,59916,24,32,202,76,1378,10.428571428571429,17.405319828712578,"(3.999, 24.0]",Q1
36021,2020-05-01,59916,24,3,205,37,1415,9.285714285714286,15.49788751871668,"(3.999, 24.0]",Q1
36021,2020-05-02,59916,24,4,209,57,1472,9.428571428571429,15.736316557466166,"(3.999, 24.0]",Q1
36021,2020-05-03,59916,24,4,213,38,1510,9.571428571428571,15.974745596215653,"(3.999, 24.0]",Q1
36021,2020-05-04,59916,24,16,229,79,1589,10.714285714285714,17.882177906211552,"(3.999, 24.0]",Q1
36021,2020-05-05,59916,24,62,291,188,1777,18.0,30.04205888243541,"(3.999, 24.0]",Q1
36021,2020-05-06,59916,24,11,302,58,1835,18.857142857142858,31.472633114932332,"(3.999, 24.0]",Q1
36021,2020-05-07,59916,24,2,304,70,1905,14.571428571428571,24.31976195244771,"(3.999, 24.0]",Q1
36021,2020-05-08,59916,24,0,304,42,1947,14.142857142857142,23.60447483619925,"(3.999, 24.0]",Q1
36021,2020-05-09,59916,24,8,312,264,2211,14.714285714285714,24.558190991197197,"(3.999, 24.0]",Q1
36021,2020-05-10,59916,24,2,314,41,2252,14.428571428571429,24.081332913698226,"(3.999, 24.0]",Q1
36021,2020-05-11,59916,24,0,314,55,2307,12.142857142857142,20.266468293706428,"(3.999, 24.0]",Q1
36021,2020-05-12,59916,24,4,318,85,2392,3.857142857142857,6.437584046236159,"(3.999, 24.0]",Q1
36021,2020-05-13,59916,24,9,327,100,2492,3.5714285714285716,5.960725968737185,"(3.999, 24.0]",Q1
36021,2020-05-14,59916,24,6,333,95,2587,4.142857142857143,6.914442123735134,"(3.999, 24.0]",Q1
36021,2020-05-15,59916,24,5,338,71,2658,4.857142857142857,8.106587317482571,"(3.999, 24.0]",Q1
36021,2020-05-16,59916,24,2,340,68,2726,4.0,6.676013084985647,"(3.999, 24.0]",Q1
36021,2020-05-17,59916,24,6,346,86,2812,4.571428571428571,7.629729239983596,"(3.999, 24.0]",Q1
36021,2020-05-18,59916,24,4,350,39,2851,5.142857142857143,8.583445394981545,"(3.999, 24.0]",Q1
36021,2020-05-19,59916,24,0,350,107,2958,4.571428571428571,7.629729239983596,"(3.999, 24.0]",Q1
36021,2020-05-20,59916,24,5,355,128,3086,4.0,6.676013084985647,"(3.999, 24.0]",Q1
36021,2020-05-21,59916,24,1,356,78,3164,3.2857142857142856,5.4838678912382095,"(3.999, 24.0]",Q1
36021,2020-05-22,59916,24,3,359,96,3260,3.0,5.007009813739235,"(3.999, 24.0]",Q1
36021,2020-05-23,59916,24,6,365,94,3354,3.5714285714285716,5.960725968737185,"(3.999, 24.0]",Q1
36021,2020-05-24,59916,24,7,372,134,3488,3.7142857142857144,6.199155007486672,"(3.999, 24.0]",Q1
36021,2020-05-25,59916,24,1,373,145,3633,3.2857142857142856,5.4838678912382095,"(3.999, 24.0]",Q1
36021,2020-05-26,59916,24,7,380,62,3695,4.285714285714286,7.152871162484621,"(3.999, 24.0]",Q1
36021,2020-05-27,59916,24,0,380,145,3840,3.5714285714285716,5.960725968737185,"(3.999, 24.0]",Q1
36021,2020-05-28,59916,24,2,382,159,3999,3.7142857142857144,6.199155007486672,"(3.999, 24.0]",Q1
36021,2020-05-29,59916,24,1,383,125,4124,3.4285714285714284,5.722296929987697,"(3.999, 24.0]",Q1
36021,2020-05-30,59916,24,4,387,211,4335,3.142857142857143,5.245438852488722,"(3.999, 24.0]",Q1
36021,2020-05-31,59916,24,2,389,94,4429,2.4285714285714284,4.0532936587412856,"(3.999, 24.0]",Q1
36021,2020-06-01,59916,24,2,391,167,4596,2.5714285714285716,4.291722697490773,"(3.999, 24.0]",Q1
36021,2020-06-02,59916,24,8,399,393,4989,2.7142857142857144,4.530151736240261,"(3.999, 24.0]",Q1
36021,2020-06-03,59916,24,1,400,276,5265,2.857142857142857,4.768580774989747,"(3.999, 24.0]",Q1
36021,2020-06-04,59916,24,11,411,269,5534,4.142857142857143,6.914442123735134,"(3.999, 24.0]",Q1
36021,2020-06-05,59916,24,1,412,225,5759,4.142857142857143,6.914442123735134,"(3.999, 24.0]",Q1
36021,2020-06-06,59916,24,2,414,211,5970,3.857142857142857,6.437584046236159,"(3.999, 24.0]",Q1
36021,2020-06-07,59916,24,0,414,144,6114,3.5714285714285716,5.960725968737185,"(3.999, 24.0]",Q1
36023,2020-03-02,47823,38,0,0,0,0,0.0,0.0,"(37.5, 52.0]",Q3
36023,2020-03-03,47823,38,0,0,0,0,0.0,0.0,"(37.5, 52.0]",Q3
36023,2020-03-04,47823,38,0,0,0,0,0.0,0.0,"(37.5, 52.0]",Q3
36023,2020-03-05,47823,38,0,0,0,0,0.0,0.0,"(37.5, 52.0]",Q3
36023,2020-03-06,47823,38,0,0,0,0,0.0,0.0,"(37.5, 52.0]",Q3
36023,2020-03-07,47823,38,0,0,1,1,0.0,0.0,"(37.5, 52.0]",Q3
36023,2020-03-08,47823,38,0,0,0,1,0.0,0.0,"(37.5, 52.0]",Q3
36023,2020-03-09,47823,38,0,0,0,1,0.0,0.0,"(37.5, 52.0]",Q3
36023,2020-03-10,47823,38,0,0,0,1,0.0,0.0,"(37.5, 52.0]",Q3
36023,2020-03-11,47823,38,0,0,0,1,0.0,0.0,"(37.5, 52.0]",Q3
36023,2020-03-12,47823,38,0,0,0,1,0.0,0.0,"(37.5, 52.0]",Q3
36023,2020-03-13,47823,38,0,0,0,1,0.0,0.0,"(37.5, 52.0]",Q3
36023,2020-03-14,47823,38,0,0,1,2,0.0,0.0,"(37.5, 52.0]",Q3
36023,2020-03-15,47823,38,0,0,0,2,0.0,0.0,"(37.5, 52.0]",Q3
36023,2020-03-16,47823,38,0,0,2,4,0.0,0.0,"(37.5, 52.0]",Q3
36023,2020-03-17,47823,38,0,0,1,5,0.0,0.0,"(37.5, 52.0]",Q3
36023,2020-03-18,47823,38,0,0,1,6,0.0,0.0,"(37.5, 52.0]",Q3
36023,2020-03-19,47823,38,0,0,7,13,0.0,0.0,"(37.5, 52.0]",Q3
36023,2020-03-20,47823,38,0,0,15,28,0.0,0.0,"(37.5, 52.0]",Q3
36023,2020-03-21,47823,38,1,1,17,45,0.14285714285714285,0.2987205797569012,"(37.5, 52.0]",Q3
36023,2020-03-22,47823,38,1,2,55,100,0.2857142857142857,0.5974411595138024,"(37.5, 52.0]",Q3
36023,2020-03-23,47823,38,0,2,30,130,0.2857142857142857,0.5974411595138024,"(37.5, 52.0]",Q3
36023,2020-03-24,47823,38,0,2,3,133,0.2857142857142857,0.5974411595138024,"(37.5, 52.0]",Q3
36023,2020-03-25,47823,38,0,2,41,174,0.2857142857142857,0.5974411595138024,"(37.5, 52.0]",Q3
36023,2020-03-26,47823,38,2,4,34,208,0.5714285714285714,1.1948823190276048,"(37.5, 52.0]",Q3
36023,2020-03-27,47823,38,1,5,45,253,0.7142857142857143,1.493602898784506,"(37.5, 52.0]",Q3
36023,2020-03-28,47823,38,1,6,28,281,0.7142857142857143,1.493602898784506,"(37.5, 52.0]",Q3
36023,2020-03-29,47823,38,2,8,48,329,0.8571428571428571,1.792323478541407,"(37.5, 52.0]",Q3
36023,2020-03-30,47823,38,0,8,9,338,0.8571428571428571,1.792323478541407,"(37.5, 52.0]",Q3
36023,2020-03-31,47823,38,0,8,12,350,0.8571428571428571,1.792323478541407,"(37.5, 52.0]",Q3
36023,2020-04-01,47823,38,0,8,42,392,0.8571428571428571,1.792323478541407,"(37.5, 52.0]",Q3
36023,2020-04-02,47823,38,2,10,54,446,0.8571428571428571,1.792323478541407,"(37.5, 52.0]",Q3
36023,2020-04-03,47823,38,0,10,32,478,0.7142857142857143,1.493602898784506,"(37.5, 52.0]",Q3
36023,2020-04-04,47823,38,0,10,38,516,0.5714285714285714,1.1948823190276048,"(37.5, 52.0]",Q3
36023,2020-04-05,47823,38,3,13,42,558,0.7142857142857143,1.493602898784506,"(37.5, 52.0]",Q3
36023,2020-04-06,47823,38,3,16,25,583,1.1428571428571428,2.3897646380552096,"(37.5, 52.0]",Q3
36023,2020-04-07,47823,38,0,16,18,601,1.1428571428571428,2.3897646380552096,"(37.5, 52.0]",Q3
36023,2020-04-08,47823,38,0,16,41,642,1.1428571428571428,2.3897646380552096,"(37.5, 52.0]",Q3
36023,2020-04-09,47823,38,1,17,25,667,1.0,2.091044058298308,"(37.5, 52.0]",Q3
36023,2020-04-10,47823,38,0,17,20,687,1.0,2.091044058298308,"(37.5, 52.0]",Q3
36023,2020-04-11,47823,38,1,18,18,705,1.1428571428571428,2.3897646380552096,"(37.5, 52.0]",Q3
36023,2020-04-12,47823,38,2,20,18,723,1.0,2.091044058298308,"(37.5, 52.0]",Q3
36023,2020-04-13,47823,38,2,22,38,761,0.8571428571428571,1.792323478541407,"(37.5, 52.0]",Q3
36023,2020-04-14,47823,38,1,23,6,767,1.0,2.091044058298308,"(37.5, 52.0]",Q3
36023,2020-04-15,47823,38,1,24,17,784,1.1428571428571428,2.3897646380552096,"(37.5, 52.0]",Q3
36023,2020-04-16,47823,38,1,25,13,797,1.1428571428571428,2.3897646380552096,"(37.5, 52.0]",Q3
36023,2020-04-17,47823,38,0,25,19,816,1.1428571428571428,2.3897646380552096,"(37.5, 52.0]",Q3
36023,2020-04-18,47823,38,0,25,11,827,1.0,2.091044058298308,"(37.5, 52.0]",Q3
36023,2020-04-19,47823,38,0,25,12,839,0.7142857142857143,1.493602898784506,"(37.5, 52.0]",Q3
36023,2020-04-20,47823,38,0,25,2,841,0.42857142857142855,0.8961617392707035,"(37.5, 52.0]",Q3
36023,2020-04-21,47823,38,0,25,5,846,0.2857142857142857,0.5974411595138024,"(37.5, 52.0]",Q3
36023,2020-04-22,47823,38,0,25,30,876,0.14285714285714285,0.2987205797569012,"(37.5, 52.0]",Q3
36023,2020-04-23,47823,38,0,25,30,906,0.0,0.0,"(37.5, 52.0]",Q3
36023,2020-04-24,47823,38,3,28,109,1015,0.42857142857142855,0.8961617392707035,"(37.5, 52.0]",Q3
36023,2020-04-25,47823,38,0,28,26,1041,0.42857142857142855,0.8961617392707035,"(37.5, 52.0]",Q3
36023,2020-04-26,47823,38,0,28,16,1057,0.42857142857142855,0.8961617392707035,"(37.5, 52.0]",Q3
36023,2020-04-27,47823,38,0,28,7,1064,0.42857142857142855,0.8961617392707035,"(37.5, 52.0]",Q3
36023,2020-04-28,47823,38,0,28,22,1086,0.42857142857142855,0.8961617392707035,"(37.5, 52.0]",Q3
36023,2020-04-29,47823,38,0,28,26,1112,0.42857142857142855,0.8961617392707035,"(37.5, 52.0]",Q3
36023,2020-04-30,47823,38,0,28,31,1143,0.42857142857142855,0.8961617392707035,"(37.5, 52.0]",Q3
36023,2020-05-01,47823,38,0,28,30,1173,0.0,0.0,"(37.5, 52.0]",Q3
36023,2020-05-02,47823,38,0,28,16,1189,0.0,0.0,"(37.5, 52.0]",Q3
36023,2020-05-03,47823,38,0,28,42,1231,0.0,0.0,"(37.5, 52.0]",Q3
36023,2020-05-04,47823,38,0,28,12,1243,0.0,0.0,"(37.5, 52.0]",Q3
36023,2020-05-05,47823,38,0,28,33,1276,0.0,0.0,"(37.5, 52.0]",Q3
36023,2020-05-06,47823,38,1,29,27,1303,0.14285714285714285,0.2987205797569012,"(37.5, 52.0]",Q3
36023,2020-05-07,47823,38,0,29,38,1341,0.14285714285714285,0.2987205797569012,"(37.5, 52.0]",Q3
36023,2020-05-08,47823,38,0,29,96,1437,0.14285714285714285,0.2987205797569012,"(37.5, 52.0]",Q3
36023,2020-05-09,47823,38,0,29,29,1466,0.14285714285714285,0.2987205797569012,"(37.5, 52.0]",Q3
36023,2020-05-10,47823,38,0,29,27,1493,0.14285714285714285,0.2987205797569012,"(37.5, 52.0]",Q3
36023,2020-05-11,47823,38,1,30,33,1526,0.2857142857142857,0.5974411595138024,"(37.5, 52.0]",Q3
36023,2020-05-12,47823,38,1,31,40,1566,0.42857142857142855,0.8961617392707035,"(37.5, 52.0]",Q3
36023,2020-05-13,47823,38,2,33,50,1616,0.5714285714285714,1.1948823190276048,"(37.5, 52.0]",Q3
36023,2020-05-14,47823,38,0,33,95,1711,0.5714285714285714,1.1948823190276048,"(37.5, 52.0]",Q3
36023,2020-05-15,47823,38,1,34,221,1932,0.7142857142857143,1.493602898784506,"(37.5, 52.0]",Q3
36023,2020-05-16,47823,38,0,34,140,2072,0.7142857142857143,1.493602898784506,"(37.5, 52.0]",Q3
36023,2020-05-17,47823,38,1,35,99,2171,0.8571428571428571,1.792323478541407,"(37.5, 52.0]",Q3
36023,2020-05-18,47823,38,1,36,62,2233,0.8571428571428571,1.792323478541407,"(37.5, 52.0]",Q3
36023,2020-05-19,47823,38,0,36,77,2310,0.7142857142857143,1.493602898784506,"(37.5, 52.0]",Q3
36023,2020-05-20,47823,38,0,36,144,2454,0.42857142857142855,0.8961617392707035,"(37.5, 52.0]",Q3
36023,2020-05-21,47823,38,1,37,86,2540,0.5714285714285714,1.1948823190276048,"(37.5, 52.0]",Q3
36023,2020-05-22,47823,38,1,38,223,2763,0.5714285714285714,1.1948823190276048,"(37.5, 52.0]",Q3
36023,2020-05-23,47823,38,1,39,147,2910,0.7142857142857143,1.493602898784506,"(37.5, 52.0]",Q3
36023,2020-05-24,47823,38,0,39,221,3131,0.5714285714285714,1.1948823190276048,"(37.5, 52.0]",Q3
36023,2020-05-25,47823,38,0,39,64,3195,0.42857142857142855,0.8961617392707035,"(37.5, 52.0]",Q3
36023,2020-05-26,47823,38,0,39,82,3277,0.42857142857142855,0.8961617392707035,"(37.5, 52.0]",Q3
36023,2020-05-27,47823,38,0,39,34,3311,0.42857142857142855,0.8961617392707035,"(37.5, 52.0]",Q3
36023,2020-05-28,47823,38,0,39,207,3518,0.2857142857142857,0.5974411595138024,"(37.5, 52.0]",Q3
36023,2020-05-29,47823,38,2,41,188,3706,0.42857142857142855,0.8961617392707035,"(37.5, 52.0]",Q3
36023,2020-05-30,47823,38,0,41,261,3967,0.2857142857142857,0.5974411595138024,"(37.5, 52.0]",Q3
36023,2020-05-31,47823,38,0,41,84,4051,0.2857142857142857,0.5974411595138024,"(37.5, 52.0]",Q3
36023,2020-06-01,47823,38,0,41,128,4179,0.2857142857142857,0.5974411595138024,"(37.5, 52.0]",Q3
36023,2020-06-02,47823,38,0,41,92,4271,0.2857142857142857,0.5974411595138024,"(37.5, 52.0]",Q3
36023,2020-06-03,47823,38,0,41,130,4401,0.2857142857142857,0.5974411595138024,"(37.5, 52.0]",Q3
36023,2020-06-04,47823,38,0,41,343,4744,0.2857142857142857,0.5974411595138024,"(37.5, 52.0]",Q3
36023,2020-06-05,47823,38,0,41,294,5038,0.0,0.0,"(37.5, 52.0]",Q3
36023,2020-06-06,47823,38,0,41,201,5239,0.0,0.0,"(37.5, 52.0]",Q3
36023,2020-06-07,47823,38,1,42,179,5418,0.14285714285714285,0.2987205797569012,"(37.5, 52.0]",Q3
36025,2020-03-02,44527,51,0,0,0,0,0.0,0.0,"(37.5, 52.0]",Q3
36025,2020-03-03,44527,51,0,0,0,0,0.0,0.0,"(37.5, 52.0]",Q3
36025,2020-03-04,44527,51,0,0,0,0,0.0,0.0,"(37.5, 52.0]",Q3
36025,2020-03-05,44527,51,0,0,0,0,0.0,0.0,"(37.5, 52.0]",Q3
36025,2020-03-06,44527,51,0,0,0,0,0.0,0.0,"(37.5, 52.0]",Q3
36025,2020-03-07,44527,51,0,0,0,0,0.0,0.0,"(37.5, 52.0]",Q3
36025,2020-03-08,44527,51,0,0,0,0,0.0,0.0,"(37.5, 52.0]",Q3
36025,2020-03-09,44527,51,0,0,1,1,0.0,0.0,"(37.5, 52.0]",Q3
36025,2020-03-10,44527,51,0,0,1,2,0.0,0.0,"(37.5, 52.0]",Q3
36025,2020-03-11,44527,51,0,0,2,4,0.0,0.0,"(37.5, 52.0]",Q3
36025,2020-03-12,44527,51,1,1,1,5,0.14285714285714285,0.3208326248279535,"(37.5, 52.0]",Q3
36025,2020-03-13,44527,51,0,1,1,6,0.14285714285714285,0.3208326248279535,"(37.5, 52.0]",Q3
36025,2020-03-14,44527,51,0,1,1,7,0.14285714285714285,0.3208326248279535,"(37.5, 52.0]",Q3
36025,2020-03-15,44527,51,0,1,5,12,0.14285714285714285,0.3208326248279535,"(37.5, 52.0]",Q3
36025,2020-03-16,44527,51,0,1,0,12,0.14285714285714285,0.3208326248279535,"(37.5, 52.0]",Q3
36025,2020-03-17,44527,51,0,1,0,12,0.14285714285714285,0.3208326248279535,"(37.5, 52.0]",Q3
36025,2020-03-18,44527,51,0,1,1,13,0.14285714285714285,0.3208326248279535,"(37.5, 52.0]",Q3
36025,2020-03-19,44527,51,0,1,4,17,0.0,0.0,"(37.5, 52.0]",Q3
36025,2020-03-20,44527,51,0,1,8,25,0.0,0.0,"(37.5, 52.0]",Q3
36025,2020-03-21,44527,51,2,3,10,35,0.2857142857142857,0.641665249655907,"(37.5, 52.0]",Q3
36025,2020-03-22,44527,51,0,3,10,45,0.2857142857142857,0.641665249655907,"(37.5, 52.0]",Q3
36025,2020-03-23,44527,51,0,3,5,50,0.2857142857142857,0.641665249655907,"(37.5, 52.0]",Q3
36025,2020-03-24,44527,51,2,5,5,55,0.5714285714285714,1.283330499311814,"(37.5, 52.0]",Q3
36025,2020-03-25,44527,51,2,7,12,67,0.8571428571428571,1.924995748967721,"(37.5, 52.0]",Q3
36025,2020-03-26,44527,51,1,8,7,74,1.0,2.2458283737956743,"(37.5, 52.0]",Q3
36025,2020-03-27,44527,51,0,8,13,87,1.0,2.2458283737956743,"(37.5, 52.0]",Q3
36025,2020-03-28,44527,51,0,8,4,91,0.7142857142857143,1.6041631241397676,"(37.5, 52.0]",Q3
36025,2020-03-29,44527,51,3,11,12,103,1.1428571428571428,2.566660998623628,"(37.5, 52.0]",Q3
36025,2020-03-30,44527,51,5,16,11,114,1.8571428571428572,4.1708241227633955,"(37.5, 52.0]",Q3
36025,2020-03-31,44527,51,4,20,13,127,2.142857142857143,4.812489372419302,"(37.5, 52.0]",Q3
36025,2020-04-01,44527,51,2,22,7,134,2.142857142857143,4.812489372419302,"(37.5, 52.0]",Q3
36025,2020-04-02,44527,51,2,24,9,143,2.2857142857142856,5.133321997247256,"(37.5, 52.0]",Q3
36025,2020-04-03,44527,51,2,26,18,161,2.5714285714285716,5.774987246903164,"(37.5, 52.0]",Q3
36025,2020-04-04,44527,51,1,27,12,173,2.7142857142857144,6.095819871731117,"(37.5, 52.0]",Q3
36025,2020-04-05,44527,51,2,29,28,201,2.5714285714285716,5.774987246903164,"(37.5, 52.0]",Q3
36025,2020-04-06,44527,51,7,36,30,231,2.857142857142857,6.41665249655907,"(37.5, 52.0]",Q3
36025,2020-04-07,44527,51,1,37,16,247,2.4285714285714284,5.454154622075209,"(37.5, 52.0]",Q3
36025,2020-04-08,44527,51,0,37,22,269,2.142857142857143,4.812489372419302,"(37.5, 52.0]",Q3
36025,2020-04-09,44527,51,2,39,20,289,2.142857142857143,4.812489372419302,"(37.5, 52.0]",Q3
36025,2020-04-10,44527,51,0,39,17,306,1.8571428571428572,4.1708241227633955,"(37.5, 52.0]",Q3
36025,2020-04-11,44527,51,0,39,10,316,1.7142857142857142,3.849991497935442,"(37.5, 52.0]",Q3
36025,2020-04-12,44527,51,3,42,14,330,1.8571428571428572,4.1708241227633955,"(37.5, 52.0]",Q3
36025,2020-04-13,44527,51,3,45,48,378,1.2857142857142858,2.887493623451582,"(37.5, 52.0]",Q3
36025,2020-04-14,44527,51,1,46,7,385,1.2857142857142858,2.887493623451582,"(37.5, 52.0]",Q3
36025,2020-04-15,44527,51,1,47,9,394,1.4285714285714286,3.208326248279535,"(37.5, 52.0]",Q3
36025,2020-04-16,44527,51,1,48,10,404,1.2857142857142858,2.887493623451582,"(37.5, 52.0]",Q3
36025,2020-04-17,44527,51,1,49,8,412,1.4285714285714286,3.208326248279535,"(37.5, 52.0]",Q3
36025,2020-04-18,44527,51,0,49,10,422,1.4285714285714286,3.208326248279535,"(37.5, 52.0]",Q3
36025,2020-04-19,44527,51,0,49,5,427,1.0,2.2458283737956743,"(37.5, 52.0]",Q3
36025,2020-04-20,44527,51,0,49,3,430,0.5714285714285714,1.283330499311814,"(37.5, 52.0]",Q3
36025,2020-04-21,44527,51,1,50,18,448,0.5714285714285714,1.283330499311814,"(37.5, 52.0]",Q3
36025,2020-04-22,44527,51,0,50,21,469,0.42857142857142855,0.9624978744838605,"(37.5, 52.0]",Q3
36025,2020-04-23,44527,51,1,51,15,484,0.42857142857142855,0.9624978744838605,"(37.5, 52.0]",Q3
36025,2020-04-24,44527,51,7,58,135,619,1.2857142857142858,2.887493623451582,"(37.5, 52.0]",Q3
36025,2020-04-25,44527,51,0,58,35,654,1.2857142857142858,2.887493623451582,"(37.5, 52.0]",Q3
36025,2020-04-26,44527,51,0,58,21,675,1.2857142857142858,2.887493623451582,"(37.5, 52.0]",Q3
36025,2020-04-27,44527,51,1,59,16,691,1.4285714285714286,3.208326248279535,"(37.5, 52.0]",Q3
36025,2020-04-28,44527,51,1,60,14,705,1.4285714285714286,3.208326248279535,"(37.5, 52.0]",Q3
36025,2020-04-29,44527,51,1,61,24,729,1.5714285714285714,3.5291588731074883,"(37.5, 52.0]",Q3
36025,2020-04-30,44527,51,0,61,24,753,1.4285714285714286,3.208326248279535,"(37.5, 52.0]",Q3
36025,2020-05-01,44527,51,0,61,29,782,0.42857142857142855,0.9624978744838605,"(37.5, 52.0]",Q3
36025,2020-05-02,44527,51,0,61,28,810,0.42857142857142855,0.9624978744838605,"(37.5, 52.0]",Q3
36025,2020-05-03,44527,51,1,62,54,864,0.5714285714285714,1.283330499311814,"(37.5, 52.0]",Q3
36025,2020-05-04,44527,51,0,62,31,895,0.42857142857142855,0.9624978744838605,"(37.5, 52.0]",Q3
36025,2020-05-05,44527,51,0,62,30,925,0.2857142857142857,0.641665249655907,"(37.5, 52.0]",Q3
36025,2020-05-06,44527,51,1,63,30,955,0.2857142857142857,0.641665249655907,"(37.5, 52.0]",Q3
36025,2020-05-07,44527,51,0,63,24,979,0.2857142857142857,0.641665249655907,"(37.5, 52.0]",Q3
36025,2020-05-08,44527,51,0,63,30,1009,0.2857142857142857,0.641665249655907,"(37.5, 52.0]",Q3
36025,2020-05-09,44527,51,1,64,33,1042,0.42857142857142855,0.9624978744838605,"(37.5, 52.0]",Q3
36025,2020-05-10,44527,51,1,65,19,1061,0.42857142857142855,0.9624978744838605,"(37.5, 52.0]",Q3
36025,2020-05-11,44527,51,0,65,50,1111,0.42857142857142855,0.9624978744838605,"(37.5, 52.0]",Q3
36025,2020-05-12,44527,51,1,66,53,1164,0.5714285714285714,1.283330499311814,"(37.5, 52.0]",Q3
36025,2020-05-13,44527,51,1,67,136,1300,0.5714285714285714,1.283330499311814,"(37.5, 52.0]",Q3
36025,2020-05-14,44527,51,0,67,120,1420,0.5714285714285714,1.283330499311814,"(37.5, 52.0]",Q3
36025,2020-05-15,44527,51,1,68,70,1490,0.7142857142857143,1.6041631241397676,"(37.5, 52.0]",Q3
36025,2020-05-16,44527,51,1,69,51,1541,0.7142857142857143,1.6041631241397676,"(37.5, 52.0]",Q3
36025,2020-05-17,44527,51,0,69,56,1597,0.5714285714285714,1.283330499311814,"(37.5, 52.0]",Q3
36025,2020-05-18,44527,51,0,69,65,1662,0.5714285714285714,1.283330499311814,"(37.5, 52.0]",Q3
36025,2020-05-19,44527,51,0,69,45,1707,0.42857142857142855,0.9624978744838605,"(37.5, 52.0]",Q3
36025,2020-05-20,44527,51,2,71,65,1772,0.5714285714285714,1.283330499311814,"(37.5, 52.0]",Q3
36025,2020-05-21,44527,51,1,72,124,1896,0.7142857142857143,1.6041631241397676,"(37.5, 52.0]",Q3
36025,2020-05-22,44527,51,2,74,51,1947,0.8571428571428571,1.924995748967721,"(37.5, 52.0]",Q3
36025,2020-05-23,44527,51,3,77,80,2027,1.1428571428571428,2.566660998623628,"(37.5, 52.0]",Q3
36025,2020-05-24,44527,51,0,77,44,2071,1.1428571428571428,2.566660998623628,"(37.5, 52.0]",Q3
36025,2020-05-25,44527,51,0,77,22,2093,1.1428571428571428,2.566660998623628,"(37.5, 52.0]",Q3
36025,2020-05-26,44527,51,1,78,205,2298,1.2857142857142858,2.887493623451582,"(37.5, 52.0]",Q3
36025,2020-05-27,44527,51,0,78,213,2511,1.0,2.2458283737956743,"(37.5, 52.0]",Q3
36025,2020-05-28,44527,51,1,79,156,2667,1.0,2.2458283737956743,"(37.5, 52.0]",Q3
36025,2020-05-29,44527,51,0,79,123,2790,0.7142857142857143,1.6041631241397676,"(37.5, 52.0]",Q3
36025,2020-05-30,44527,51,0,79,209,2999,0.2857142857142857,0.641665249655907,"(37.5, 52.0]",Q3
36025,2020-05-31,44527,51,2,81,96,3095,0.5714285714285714,1.283330499311814,"(37.5, 52.0]",Q3
36025,2020-06-01,44527,51,1,82,138,3233,0.7142857142857143,1.6041631241397676,"(37.5, 52.0]",Q3
36025,2020-06-02,44527,51,0,82,195,3428,0.5714285714285714,1.283330499311814,"(37.5, 52.0]",Q3
36025,2020-06-03,44527,51,0,82,171,3599,0.5714285714285714,1.283330499311814,"(37.5, 52.0]",Q3
36025,2020-06-04,44527,51,2,84,129,3728,0.7142857142857143,1.6041631241397676,"(37.5, 52.0]",Q3
36025,2020-06-05,44527,51,1,85,217,3945,0.8571428571428571,1.924995748967721,"(37.5, 52.0]",Q3
36025,2020-06-06,44527,51,0,85,124,4069,0.8571428571428571,1.924995748967721,"(37.5, 52.0]",Q3
36025,2020-06-07,44527,51,0,85,164,4233,0.5714285714285714,1.283330499311814,"(37.5, 52.0]",Q3
36027,2020-03-02,293718,26,0,0,0,0,0.0,0.0,"(24.0, 37.5]",Q2
36027,2020-03-03,293718,26,0,0,0,0,0.0,0.0,"(24.0, 37.5]",Q2
36027,2020-03-04,293718,26,0,0,0,0,0.0,0.0,"(24.0, 37.5]",Q2
36027,2020-03-05,293718,26,0,0,0,0,0.0,0.0,"(24.0, 37.5]",Q2
36027,2020-03-06,293718,26,0,0,0,0,0.0,0.0,"(24.0, 37.5]",Q2
36027,2020-03-07,293718,26,0,0,0,0,0.0,0.0,"(24.0, 37.5]",Q2
36027,2020-03-08,293718,26,0,0,0,0,0.0,0.0,"(24.0, 37.5]",Q2
36027,2020-03-09,293718,26,0,0,0,0,0.0,0.0,"(24.0, 37.5]",Q2
36027,2020-03-10,293718,26,0,0,2,2,0.0,0.0,"(24.0, 37.5]",Q2
36027,2020-03-11,293718,26,1,1,5,7,0.14285714285714285,0.04863751722984048,"(24.0, 37.5]",Q2
36027,2020-03-12,293718,26,0,1,3,10,0.14285714285714285,0.04863751722984048,"(24.0, 37.5]",Q2
36027,2020-03-13,293718,26,2,3,10,20,0.42857142857142855,0.1459125516895214,"(24.0, 37.5]",Q2
36027,2020-03-14,293718,26,4,7,17,37,1.0,0.3404626206088833,"(24.0, 37.5]",Q2
36027,2020-03-15,293718,26,3,10,20,57,1.4285714285714286,0.4863751722984048,"(24.0, 37.5]",Q2
36027,2020-03-16,293718,26,6,16,32,89,2.2857142857142856,0.7782002756774477,"(24.0, 37.5]",Q2
36027,2020-03-17,293718,26,4,20,23,112,2.857142857142857,0.9727503445968096,"(24.0, 37.5]",Q2
36027,2020-03-18,293718,26,11,31,107,219,4.285714285714286,1.4591255168952144,"(24.0, 37.5]",Q2
36027,2020-03-19,293718,26,5,36,59,278,5.0,1.7023131030444167,"(24.0, 37.5]",Q2
36027,2020-03-20,293718,26,13,49,205,483,6.571428571428571,2.237325792572662,"(24.0, 37.5]",Q2
36027,2020-03-21,293718,26,33,82,205,688,10.714285714285714,3.647813792238036,"(24.0, 37.5]",Q2
36027,2020-03-22,293718,26,18,100,135,823,12.857142857142858,4.377376550685644,"(24.0, 37.5]",Q2
36027,2020-03-23,293718,26,24,124,111,934,15.428571428571429,5.252851860822772,"(24.0, 37.5]",Q2
36027,2020-03-24,293718,26,29,153,146,1080,19.0,6.468789791568783,"(24.0, 37.5]",Q2
36027,2020-03-25,293718,26,37,190,209,1289,22.714285714285715,7.733365239544637,"(24.0, 37.5]",Q2
36027,2020-03-26,293718,26,35,225,155,1444,27.0,9.19249075643985,"(24.0, 37.5]",Q2
36027,2020-03-27,293718,26,37,262,200,1644,30.428571428571427,10.35979116995602,"(24.0, 37.5]",Q2
36027,2020-03-28,293718,26,58,320,195,1839,34.0,11.575729100702034,"(24.0, 37.5]",Q2
36027,2020-03-29,293718,26,72,392,227,2066,41.714285714285715,14.20215503111342,"(24.0, 37.5]",Q2
36027,2020-03-30,293718,26,92,484,300,2366,51.42857142857143,17.509506202742575,"(24.0, 37.5]",Q2
36027,2020-03-31,293718,26,63,547,196,2562,56.285714285714285,19.16318178855715,"(24.0, 37.5]",Q2
36027,2020-04-01,293718,26,120,667,330,2892,68.14285714285714,23.200095718633907,"(24.0, 37.5]",Q2
36027,2020-04-02,293718,26,142,809,415,3307,83.42857142857143,28.40431006222684,"(24.0, 37.5]",Q2
36027,2020-04-03,293718,26,129,938,447,3754,96.57142857142857,32.878961647372165,"(24.0, 37.5]",Q2
36027,2020-04-04,293718,26,139,1077,352,4106,108.14285714285714,36.818600542989245,"(24.0, 37.5]",Q2
36027,2020-04-05,293718,26,112,1189,338,4444,113.85714285714286,38.76410123218287,"(24.0, 37.5]",Q2
36027,2020-04-06,293718,26,60,1249,335,4779,109.28571428571429,37.20770068082797,"(24.0, 37.5]",Q2
36027,2020-04-07,293718,26,146,1395,462,5241,121.14285714285714,41.244614610904726,"(24.0, 37.5]",Q2
36027,2020-04-08,293718,26,98,1493,512,5753,118.0,40.17458923184824,"(24.0, 37.5]",Q2
36027,2020-04-09,293718,26,105,1598,509,6262,112.71428571428571,38.375001094344135,"(24.0, 37.5]",Q2
36027,2020-04-10,293718,26,146,1744,584,6846,115.14285714285714,39.20183888725143,"(24.0, 37.5]",Q2
36027,2020-04-11,293718,26,94,1838,431,7277,108.71428571428571,37.01315061190861,"(24.0, 37.5]",Q2
36027,2020-04-12,293718,26,43,1881,499,7776,98.85714285714286,33.657161923049614,"(24.0, 37.5]",Q2
36027,2020-04-13,293718,26,53,1934,566,8342,97.85714285714286,33.31669930244073,"(24.0, 37.5]",Q2
36027,2020-04-14,293718,26,114,2048,487,8829,93.28571428571429,31.760298751085834,"(24.0, 37.5]",Q2
36027,2020-04-15,293718,26,37,2085,314,9143,84.57142857142857,28.793410200065566,"(24.0, 37.5]",Q2
36027,2020-04-16,293718,26,57,2142,300,9443,77.71428571428571,26.45880937303322,"(24.0, 37.5]",Q2
36027,2020-04-17,293718,26,59,2201,381,9824,65.28571428571429,22.2273453740371,"(24.0, 37.5]",Q2
36027,2020-04-18,293718,26,39,2240,196,10020,57.42857142857143,19.552281926395874,"(24.0, 37.5]",Q2
36027,2020-04-19,293718,26,44,2284,357,10377,57.57142857142857,19.600919443625713,"(24.0, 37.5]",Q2
36027,2020-04-20,293718,26,47,2331,209,10586,56.714285714285715,19.30909434024667,"(24.0, 37.5]",Q2
36027,2020-04-21,293718,26,60,2391,313,10899,49.0,16.682668409835287,"(24.0, 37.5]",Q2
36027,2020-04-22,293718,26,69,2460,366,11265,53.57142857142857,18.239068961190178,"(24.0, 37.5]",Q2
36027,2020-04-23,293718,26,57,2517,374,11639,53.57142857142857,18.239068961190178,"(24.0, 37.5]",Q2
36027,2020-04-24,293718,26,143,2660,913,12552,65.57142857142857,22.324620408496777,"(24.0, 37.5]",Q2
36027,2020-04-25,293718,26,69,2729,485,13037,69.85714285714286,23.783745925391997,"(24.0, 37.5]",Q2
36027,2020-04-26,293718,26,64,2793,389,13426,72.71428571428571,24.756496269988798,"(24.0, 37.5]",Q2
36027,2020-04-27,293718,26,24,2817,223,13649,69.42857142857143,23.637833373702474,"(24.0, 37.5]",Q2
36027,2020-04-28,293718,26,64,2881,566,14215,70.0,23.832383442621833,"(24.0, 37.5]",Q2
36027,2020-04-29,293718,26,73,2954,427,14642,70.57142857142857,24.0269335115412,"(24.0, 37.5]",Q2
36027,2020-04-30,293718,26,48,3002,443,15085,69.28571428571429,23.589195856472635,"(24.0, 37.5]",Q2
36027,2020-05-01,293718,26,47,3049,473,15558,55.57142857142857,18.919994202407945,"(24.0, 37.5]",Q2
36027,2020-05-02,293718,26,37,3086,434,15992,51.0,17.36359365105305,"(24.0, 37.5]",Q2
36027,2020-05-03,293718,26,45,3131,370,16362,48.285714285714285,16.439480823686083,"(24.0, 37.5]",Q2
36027,2020-05-04,293718,26,20,3151,307,16669,47.714285714285715,16.24493075476672,"(24.0, 37.5]",Q2
36027,2020-05-05,293718,26,41,3192,370,17039,44.42857142857143,15.12626785848039,"(24.0, 37.5]",Q2
36027,2020-05-06,293718,26,41,3233,438,17477,39.857142857142854,13.569867307125492,"(24.0, 37.5]",Q2
36027,2020-05-07,293718,26,44,3277,482,17959,39.285714285714285,13.375317238206131,"(24.0, 37.5]",Q2
36027,2020-05-08,293718,26,42,3319,534,18493,38.57142857142857,13.132129652056927,"(24.0, 37.5]",Q2
36027,2020-05-09,293718,26,40,3359,471,18964,39.0,13.27804220374645,"(24.0, 37.5]",Q2
36027,2020-05-10,293718,26,19,3378,348,19312,35.285714285714285,12.0134667557706,"(24.0, 37.5]",Q2
36027,2020-05-11,293718,26,21,3399,216,19528,35.42857142857143,12.06210427300044,"(24.0, 37.5]",Q2
36027,2020-05-12,293718,26,30,3429,387,19915,33.857142857142854,11.527091583472194,"(24.0, 37.5]",Q2
36027,2020-05-13,293718,26,45,3474,459,20374,34.42857142857143,11.721641652391556,"(24.0, 37.5]",Q2
36027,2020-05-14,293718,26,24,3498,394,20768,31.571428571428573,10.748891307794747,"(24.0, 37.5]",Q2
36027,2020-05-15,293718,26,29,3527,627,21395,29.714285714285715,10.116603583806821,"(24.0, 37.5]",Q2
36027,2020-05-16,293718,26,16,3543,491,21886,26.285714285714285,8.949303170290648,"(24.0, 37.5]",Q2
36027,2020-05-17,293718,26,9,3552,337,22223,24.857142857142858,8.462927997992242,"(24.0, 37.5]",Q2
36027,2020-05-18,293718,26,158,3710,972,23195,44.42857142857143,15.12626785848039,"(24.0, 37.5]",Q2
36027,2020-05-19,293718,26,14,3724,536,23731,42.142857142857146,14.348067582802942,"(24.0, 37.5]",Q2
36027,2020-05-20,293718,26,21,3745,573,24304,38.714285714285715,13.18076716928677,"(24.0, 37.5]",Q2
36027,2020-05-21,293718,26,22,3767,556,24860,38.42857142857143,13.08349213482709,"(24.0, 37.5]",Q2
36027,2020-05-22,293718,26,26,3793,549,25409,38.0,12.937579583137566,"(24.0, 37.5]",Q2
36027,2020-05-23,293718,26,14,3807,874,26283,37.714285714285715,12.840304548677887,"(24.0, 37.5]",Q2
36027,2020-05-24,293718,26,18,3825,650,26933,39.0,13.27804220374645,"(24.0, 37.5]",Q2
36027,2020-05-25,293718,26,9,3834,301,27234,17.714285714285715,6.03105213650022,"(24.0, 37.5]",Q2
36027,2020-05-26,293718,26,13,3847,423,27657,17.571428571428573,5.982414619270379,"(24.0, 37.5]",Q2
36027,2020-05-27,293718,26,20,3867,911,28568,17.428571428571427,5.933777102040538,"(24.0, 37.5]",Q2
36027,2020-05-28,293718,26,20,3887,1257,29825,17.142857142857142,5.836502067580858,"(24.0, 37.5]",Q2
36027,2020-05-29,293718,26,12,3899,1265,31090,15.142857142857142,5.155576826363091,"(24.0, 37.5]",Q2
36027,2020-05-30,293718,26,10,3909,765,31855,14.571428571428571,4.961026757443729,"(24.0, 37.5]",Q2
36027,2020-05-31,293718,26,15,3924,1034,32889,14.142857142857142,4.815114205754208,"(24.0, 37.5]",Q2
36027,2020-06-01,293718,26,12,3936,936,33825,14.571428571428571,4.961026757443729,"(24.0, 37.5]",Q2
36027,2020-06-02,293718,26,15,3951,1003,34828,14.857142857142858,5.058301791903411,"(24.0, 37.5]",Q2
36027,2020-06-03,293718,26,11,3962,771,35599,13.571428571428571,4.620564136834846,"(24.0, 37.5]",Q2
36027,2020-06-04,293718,26,22,3984,1166,36765,13.857142857142858,4.717839171294527,"(24.0, 37.5]",Q2
36027,2020-06-05,293718,26,11,3995,1072,37837,13.714285714285714,4.669201654064685,"(24.0, 37.5]",Q2
36027,2020-06-06,293718,26,5,4000,793,38630,13.0,4.426014067915483,"(24.0, 37.5]",Q2
36027,2020-06-07,293718,26,6,4006,906,39536,11.714285714285714,3.988276412846919,"(24.0, 37.5]",Q2
36029,2020-03-02,919719,43,0,0,0,0,0.0,0.0,"(37.5, 52.0]",Q3
36029,2020-03-03,919719,43,0,0,0,0,0.0,0.0,"(37.5, 52.0]",Q3
36029,2020-03-04,919719,43,0,0,6,6,0.0,0.0,"(37.5, 52.0]",Q3
36029,2020-03-05,919719,43,0,0,6,12,0.0,0.0,"(37.5, 52.0]",Q3
36029,2020-03-06,919719,43,0,0,0,12,0.0,0.0,"(37.5, 52.0]",Q3
36029,2020-03-07,919719,43,0,0,2,14,0.0,0.0,"(37.5, 52.0]",Q3
36029,2020-03-08,919719,43,0,0,1,15,0.0,0.0,"(37.5, 52.0]",Q3
36029,2020-03-09,919719,43,0,0,1,16,0.0,0.0,"(37.5, 52.0]",Q3
36029,2020-03-10,919719,43,0,0,2,18,0.0,0.0,"(37.5, 52.0]",Q3
36029,2020-03-11,919719,43,0,0,0,18,0.0,0.0,"(37.5, 52.0]",Q3
36029,2020-03-12,919719,43,0,0,13,31,0.0,0.0,"(37.5, 52.0]",Q3
36029,2020-03-13,919719,43,0,0,5,36,0.0,0.0,"(37.5, 52.0]",Q3
36029,2020-03-14,919719,43,3,3,22,58,0.42857142857142855,0.04659808360721357,"(37.5, 52.0]",Q3
36029,2020-03-15,919719,43,3,6,10,68,0.8571428571428571,0.09319616721442714,"(37.5, 52.0]",Q3
36029,2020-03-16,919719,43,1,7,2,70,1.0,0.108728861750165,"(37.5, 52.0]",Q3
36029,2020-03-17,919719,43,0,7,2,72,1.0,0.108728861750165,"(37.5, 52.0]",Q3
36029,2020-03-18,919719,43,21,28,130,202,4.0,0.43491544700066,"(37.5, 52.0]",Q3
36029,2020-03-19,919719,43,3,31,43,245,4.428571428571429,0.48151353060787355,"(37.5, 52.0]",Q3
36029,2020-03-20,919719,43,7,38,55,300,5.428571428571429,0.5902423923580385,"(37.5, 52.0]",Q3
36029,2020-03-21,919719,43,16,54,111,411,7.285714285714286,0.7921674213226307,"(37.5, 52.0]",Q3
36029,2020-03-22,919719,43,33,87,247,658,11.571428571428571,1.2581482573947664,"(37.5, 52.0]",Q3
36029,2020-03-23,919719,43,20,107,100,758,14.285714285714286,1.5532694535737859,"(37.5, 52.0]",Q3
36029,2020-03-24,919719,43,15,122,114,872,16.428571428571427,1.7862598716098532,"(37.5, 52.0]",Q3
36029,2020-03-25,919719,43,12,134,116,988,15.142857142857142,1.6464656207882127,"(37.5, 52.0]",Q3
36029,2020-03-26,919719,43,85,219,348,1336,26.857142857142858,2.920146572718717,"(37.5, 52.0]",Q3
36029,2020-03-27,919719,43,99,318,370,1706,40.0,4.349154470006599,"(37.5, 52.0]",Q3
36029,2020-03-28,919719,43,40,358,126,1832,43.42857142857143,4.721939138864308,"(37.5, 52.0]",Q3
36029,2020-03-29,919719,43,18,376,67,1899,41.285714285714285,4.48894872082824,"(37.5, 52.0]",Q3
36029,2020-03-30,919719,43,62,438,189,2088,47.285714285714285,5.1413218913292305,"(37.5, 52.0]",Q3
36029,2020-03-31,919719,43,26,464,119,2207,48.857142857142854,5.312181531222347,"(37.5, 52.0]",Q3
36029,2020-04-01,919719,43,153,617,571,2778,69.0,7.502291460761385,"(37.5, 52.0]",Q3
36029,2020-04-02,919719,43,103,720,429,3207,71.57142857142857,7.781879962404665,"(37.5, 52.0]",Q3
36029,2020-04-03,919719,43,88,808,317,3524,70.0,7.611020322511551,"(37.5, 52.0]",Q3
36029,2020-04-04,919719,43,110,918,402,3926,80.0,8.698308940013199,"(37.5, 52.0]",Q3
36029,2020-04-05,919719,43,105,1023,549,4475,92.42857142857143,10.049653364622394,"(37.5, 52.0]",Q3
36029,2020-04-06,919719,43,112,1135,396,4871,99.57142857142857,10.826288091409285,"(37.5, 52.0]",Q3
36029,2020-04-07,919719,43,70,1205,295,5166,105.85714285714286,11.509726650981753,"(37.5, 52.0]",Q3
36029,2020-04-08,919719,43,157,1362,458,5624,106.42857142857143,11.571857429124703,"(37.5, 52.0]",Q3
36029,2020-04-09,919719,43,47,1409,309,5933,98.42857142857143,10.702026535123384,"(37.5, 52.0]",Q3
36029,2020-04-10,919719,43,63,1472,297,6230,94.85714285714286,10.313709171729938,"(37.5, 52.0]",Q3
36029,2020-04-11,919719,43,99,1571,317,6547,93.28571428571429,10.142849531836822,"(37.5, 52.0]",Q3
36029,2020-04-12,919719,43,53,1624,182,6729,85.85714285714286,9.335149415978453,"(37.5, 52.0]",Q3
36029,2020-04-13,919719,43,44,1668,223,6952,76.14285714285714,8.278926187548278,"(37.5, 52.0]",Q3
36029,2020-04-14,919719,43,83,1751,326,7278,78.0,8.48085121651287,"(37.5, 52.0]",Q3
36029,2020-04-15,919719,43,99,1850,394,7672,69.71428571428571,7.5799549334400735,"(37.5, 52.0]",Q3
36029,2020-04-16,919719,43,79,1929,348,8020,74.28571428571429,8.077001158583686,"(37.5, 52.0]",Q3
36029,2020-04-17,919719,43,68,1997,262,8282,75.0,8.154664631262374,"(37.5, 52.0]",Q3
36029,2020-04-18,919719,43,73,2070,367,8649,71.28571428571429,7.750814573333192,"(37.5, 52.0]",Q3
36029,2020-04-19,919719,43,39,2109,199,8848,69.28571428571429,7.5333568498328605,"(37.5, 52.0]",Q3
36029,2020-04-20,919719,43,38,2147,258,9106,68.42857142857143,7.440160682618433,"(37.5, 52.0]",Q3
36029,2020-04-21,919719,43,86,2233,347,9453,68.85714285714286,7.486758766225647,"(37.5, 52.0]",Q3
36029,2020-04-22,919719,43,217,2450,1307,10760,85.71428571428571,9.319616721442713,"(37.5, 52.0]",Q3
36029,2020-04-23,919719,43,153,2603,982,11742,96.28571428571429,10.469036117087317,"(37.5, 52.0]",Q3
36029,2020-04-24,919719,43,170,2773,872,12614,110.85714285714286,12.053370959732577,"(37.5, 52.0]",Q3
36029,2020-04-25,919719,43,181,2954,795,13409,126.28571428571429,13.730901969592267,"(37.5, 52.0]",Q3
36029,2020-04-26,919719,43,67,3021,508,13917,130.28571428571428,14.165817416592926,"(37.5, 52.0]",Q3
36029,2020-04-27,919719,43,68,3089,586,14503,134.57142857142858,14.631798252665062,"(37.5, 52.0]",Q3
36029,2020-04-28,919719,43,107,3196,716,15219,137.57142857142858,14.957984837915559,"(37.5, 52.0]",Q3
36029,2020-04-29,919719,43,123,3319,885,16104,124.14285714285714,13.497911551556195,"(37.5, 52.0]",Q3
36029,2020-04-30,919719,43,162,3481,905,17009,125.42857142857143,13.637705802377837,"(37.5, 52.0]",Q3
36029,2020-05-01,919719,43,117,3598,1058,18067,117.85714285714286,12.814472991983731,"(37.5, 52.0]",Q3
36029,2020-05-02,919719,43,112,3710,799,18866,108.0,11.74271706901782,"(37.5, 52.0]",Q3
36029,2020-05-03,919719,43,92,3802,760,19626,111.57142857142857,12.131034432411266,"(37.5, 52.0]",Q3
36029,2020-05-04,919719,43,89,3891,779,20405,114.57142857142857,12.45722101766176,"(37.5, 52.0]",Q3
36029,2020-05-05,919719,43,117,4008,1498,21903,116.0,12.61254796301914,"(37.5, 52.0]",Q3
36029,2020-05-06,919719,43,128,4136,1164,23067,116.71428571428571,12.690211435697828,"(37.5, 52.0]",Q3
36029,2020-05-07,919719,43,119,4255,1008,24075,110.57142857142857,12.022305570661102,"(37.5, 52.0]",Q3
36029,2020-05-08,919719,43,82,4337,1049,25124,105.57142857142857,11.478661261910275,"(37.5, 52.0]",Q3
36029,2020-05-09,919719,43,116,4453,1231,26355,106.14285714285714,11.540792040053226,"(37.5, 52.0]",Q3
36029,2020-05-10,919719,43,30,4483,386,26741,97.28571428571429,10.57776497883748,"(37.5, 52.0]",Q3
36029,2020-05-11,919719,43,47,4530,696,27437,91.28571428571429,9.92539180833649,"(37.5, 52.0]",Q3
36029,2020-05-12,919719,43,76,4606,1591,29028,85.42857142857143,9.288551332371238,"(37.5, 52.0]",Q3
36029,2020-05-13,919719,43,65,4671,1664,30692,76.42857142857143,8.309991576619753,"(37.5, 52.0]",Q3
36029,2020-05-14,919719,43,111,4782,1690,32382,75.28571428571429,8.18573002033385,"(37.5, 52.0]",Q3
36029,2020-05-15,919719,43,85,4867,1164,33546,75.71428571428571,8.232328103941063,"(37.5, 52.0]",Q3
36029,2020-05-16,919719,43,87,4954,1827,35373,71.57142857142857,7.781879962404665,"(37.5, 52.0]",Q3
36029,2020-05-17,919719,43,39,4993,628,36001,72.85714285714286,7.921674213226307,"(37.5, 52.0]",Q3
36029,2020-05-18,919719,43,44,5037,934,36935,72.42857142857143,7.875076129619094,"(37.5, 52.0]",Q3
36029,2020-05-19,919719,43,94,5131,2198,39133,75.0,8.154664631262374,"(37.5, 52.0]",Q3
36029,2020-05-20,919719,43,139,5270,2974,42107,85.57142857142857,9.304084026906976,"(37.5, 52.0]",Q3
36029,2020-05-21,919719,43,127,5397,2175,44282,87.85714285714286,9.552607139478782,"(37.5, 52.0]",Q3
36029,2020-05-22,919719,43,155,5552,2767,47049,97.85714285714286,10.639895756980433,"(37.5, 52.0]",Q3
36029,2020-05-23,919719,43,74,5626,1742,48791,96.0,10.43797072801584,"(37.5, 52.0]",Q3
36029,2020-05-24,919719,43,74,5700,1718,50509,101.0,10.981615036766664,"(37.5, 52.0]",Q3
36029,2020-05-25,919719,43,53,5753,1334,51843,102.28571428571429,11.121409287588307,"(37.5, 52.0]",Q3
36029,2020-05-26,919719,43,57,5810,1572,53415,97.0,10.546699589766005,"(37.5, 52.0]",Q3
36029,2020-05-27,919719,43,76,5886,2367,55782,88.0,9.56813983401452,"(37.5, 52.0]",Q3
36029,2020-05-28,919719,43,49,5935,1944,57726,76.85714285714286,8.356589660226968,"(37.5, 52.0]",Q3
36029,2020-05-29,919719,43,79,6014,2434,60160,66.0,7.17610487551089,"(37.5, 52.0]",Q3
36029,2020-05-30,919719,43,56,6070,2402,62562,63.42857142857143,6.896516373867609,"(37.5, 52.0]",Q3
36029,2020-05-31,919719,43,53,6123,1951,64513,60.42857142857143,6.570329788617114,"(37.5, 52.0]",Q3
36029,2020-06-01,919719,43,50,6173,2225,66738,60.0,6.5237317050099,"(37.5, 52.0]",Q3
36029,2020-06-02,919719,43,61,6234,3364,70102,60.57142857142857,6.585862483152851,"(37.5, 52.0]",Q3
36029,2020-06-03,919719,43,74,6308,2639,72741,60.285714285714285,6.554797094081375,"(37.5, 52.0]",Q3
36029,2020-06-04,919719,43,51,6359,2896,75637,60.57142857142857,6.585862483152851,"(37.5, 52.0]",Q3
36029,2020-06-05,919719,43,70,6429,4101,79738,59.285714285714285,6.44606823233121,"(37.5, 52.0]",Q3
36029,2020-06-06,919719,43,57,6486,2102,81840,59.42857142857143,6.461600926866948,"(37.5, 52.0]",Q3
36029,2020-06-07,919719,43,45,6531,1670,83510,58.285714285714285,6.337339370581046,"(37.5, 52.0]",Q3
36031,2020-03-02,37300,23,0,0,0,0,0.0,0.0,"(3.999, 24.0]",Q1
36031,2020-03-03,37300,23,0,0,0,0,0.0,0.0,"(3.999, 24.0]",Q1
36031,2020-03-04,37300,23,0,0,0,0,0.0,0.0,"(3.999, 24.0]",Q1
36031,2020-03-05,37300,23,0,0,0,0,0.0,0.0,"(3.999, 24.0]",Q1
36031,2020-03-06,37300,23,0,0,0,0,0.0,0.0,"(3.999, 24.0]",Q1
36031,2020-03-07,37300,23,0,0,0,0,0.0,0.0,"(3.999, 24.0]",Q1
36031,2020-03-08,37300,23,0,0,0,0,0.0,0.0,"(3.999, 24.0]",Q1
36031,2020-03-09,37300,23,0,0,0,0,0.0,0.0,"(3.999, 24.0]",Q1
36031,2020-03-10,37300,23,0,0,0,0,0.0,0.0,"(3.999, 24.0]",Q1
36031,2020-03-11,37300,23,0,0,0,0,0.0,0.0,"(3.999, 24.0]",Q1
36031,2020-03-12,37300,23,0,0,0,0,0.0,0.0,"(3.999, 24.0]",Q1
36031,2020-03-13,37300,23,0,0,2,2,0.0,0.0,"(3.999, 24.0]",Q1
36031,2020-03-14,37300,23,0,0,1,3,0.0,0.0,"(3.999, 24.0]",Q1
36031,2020-03-15,37300,23,0,0,2,5,0.0,0.0,"(3.999, 24.0]",Q1
36031,2020-03-16,37300,23,0,0,0,5,0.0,0.0,"(3.999, 24.0]",Q1
36031,2020-03-17,37300,23,1,1,2,7,0.14285714285714285,0.3829950210647261,"(3.999, 24.0]",Q1
36031,2020-03-18,37300,23,0,1,1,8,0.14285714285714285,0.3829950210647261,"(3.999, 24.0]",Q1
36031,2020-03-19,37300,23,0,1,10,18,0.14285714285714285,0.3829950210647261,"(3.999, 24.0]",Q1
36031,2020-03-20,37300,23,1,2,5,23,0.2857142857142857,0.7659900421294522,"(3.999, 24.0]",Q1
36031,2020-03-21,37300,23,1,3,8,31,0.42857142857142855,1.1489850631941785,"(3.999, 24.0]",Q1
36031,2020-03-22,37300,23,0,3,2,33,0.42857142857142855,1.1489850631941785,"(3.999, 24.0]",Q1
36031,2020-03-23,37300,23,0,3,11,44,0.42857142857142855,1.1489850631941785,"(3.999, 24.0]",Q1
36031,2020-03-24,37300,23,1,4,6,50,0.42857142857142855,1.1489850631941785,"(3.999, 24.0]",Q1
36031,2020-03-25,37300,23,0,4,7,57,0.42857142857142855,1.1489850631941785,"(3.999, 24.0]",Q1
36031,2020-03-26,37300,23,0,4,6,63,0.42857142857142855,1.1489850631941785,"(3.999, 24.0]",Q1
36031,2020-03-27,37300,23,0,4,5,68,0.2857142857142857,0.7659900421294522,"(3.999, 24.0]",Q1
36031,2020-03-28,37300,23,0,4,3,71,0.14285714285714285,0.3829950210647261,"(3.999, 24.0]",Q1
36031,2020-03-29,37300,23,0,4,3,74,0.14285714285714285,0.3829950210647261,"(3.999, 24.0]",Q1
36031,2020-03-30,37300,23,0,4,5,79,0.14285714285714285,0.3829950210647261,"(3.999, 24.0]",Q1
36031,2020-03-31,37300,23,2,6,8,87,0.2857142857142857,0.7659900421294522,"(3.999, 24.0]",Q1
36031,2020-04-01,37300,23,0,6,2,89,0.2857142857142857,0.7659900421294522,"(3.999, 24.0]",Q1
36031,2020-04-02,37300,23,0,6,2,91,0.2857142857142857,0.7659900421294522,"(3.999, 24.0]",Q1
36031,2020-04-03,37300,23,1,7,7,98,0.42857142857142855,1.1489850631941785,"(3.999, 24.0]",Q1
36031,2020-04-04,37300,23,0,7,4,102,0.42857142857142855,1.1489850631941785,"(3.999, 24.0]",Q1
36031,2020-04-05,37300,23,0,7,4,106,0.42857142857142855,1.1489850631941785,"(3.999, 24.0]",Q1
36031,2020-04-06,37300,23,0,7,5,111,0.42857142857142855,1.1489850631941785,"(3.999, 24.0]",Q1
36031,2020-04-07,37300,23,0,7,4,115,0.14285714285714285,0.3829950210647261,"(3.999, 24.0]",Q1
36031,2020-04-08,37300,23,1,8,6,121,0.2857142857142857,0.7659900421294522,"(3.999, 24.0]",Q1
36031,2020-04-09,37300,23,2,10,13,134,0.5714285714285714,1.5319800842589044,"(3.999, 24.0]",Q1
36031,2020-04-10,37300,23,2,12,4,138,0.7142857142857143,1.9149751053236308,"(3.999, 24.0]",Q1
36031,2020-04-11,37300,23,0,12,12,150,0.7142857142857143,1.9149751053236308,"(3.999, 24.0]",Q1
36031,2020-04-12,37300,23,0,12,5,155,0.7142857142857143,1.9149751053236308,"(3.999, 24.0]",Q1
36031,2020-04-13,37300,23,0,12,24,179,0.7142857142857143,1.9149751053236308,"(3.999, 24.0]",Q1
36031,2020-04-14,37300,23,0,12,3,182,0.7142857142857143,1.9149751053236308,"(3.999, 24.0]",Q1
36031,2020-04-15,37300,23,0,12,8,190,0.5714285714285714,1.5319800842589044,"(3.999, 24.0]",Q1
36031,2020-04-16,37300,23,3,15,6,196,0.7142857142857143,1.9149751053236308,"(3.999, 24.0]",Q1
36031,2020-04-17,37300,23,1,16,5,201,0.5714285714285714,1.5319800842589044,"(3.999, 24.0]",Q1
36031,2020-04-18,37300,23,2,18,10,211,0.8571428571428571,2.297970126388357,"(3.999, 24.0]",Q1
36031,2020-04-19,37300,23,2,20,4,215,1.1428571428571428,3.063960168517809,"(3.999, 24.0]",Q1
36031,2020-04-20,37300,23,1,21,5,220,1.2857142857142858,3.446955189582536,"(3.999, 24.0]",Q1
36031,2020-04-21,37300,23,1,22,2,222,1.4285714285714286,3.8299502106472616,"(3.999, 24.0]",Q1
36031,2020-04-22,37300,23,0,22,1,223,1.4285714285714286,3.8299502106472616,"(3.999, 24.0]",Q1
36031,2020-04-23,37300,23,0,22,6,229,1.0,2.680965147453083,"(3.999, 24.0]",Q1
36031,2020-04-24,37300,23,2,24,35,264,1.1428571428571428,3.063960168517809,"(3.999, 24.0]",Q1
36031,2020-04-25,37300,23,0,24,15,279,0.8571428571428571,2.297970126388357,"(3.999, 24.0]",Q1
36031,2020-04-26,37300,23,0,24,27,306,0.5714285714285714,1.5319800842589044,"(3.999, 24.0]",Q1
36031,2020-04-27,37300,23,2,26,16,322,0.7142857142857143,1.9149751053236308,"(3.999, 24.0]",Q1
36031,2020-04-28,37300,23,1,27,19,341,0.7142857142857143,1.9149751053236308,"(3.999, 24.0]",Q1
36031,2020-04-29,37300,23,1,28,22,363,0.8571428571428571,2.297970126388357,"(3.999, 24.0]",Q1
36031,2020-04-30,37300,23,0,28,27,390,0.8571428571428571,2.297970126388357,"(3.999, 24.0]",Q1
36031,2020-05-01,37300,23,0,28,31,421,0.5714285714285714,1.5319800842589044,"(3.999, 24.0]",Q1
36031,2020-05-02,37300,23,1,29,23,444,0.7142857142857143,1.9149751053236308,"(3.999, 24.0]",Q1
36031,2020-05-03,37300,23,0,29,10,454,0.7142857142857143,1.9149751053236308,"(3.999, 24.0]",Q1
36031,2020-05-04,37300,23,1,30,26,480,0.5714285714285714,1.5319800842589044,"(3.999, 24.0]",Q1
36031,2020-05-05,37300,23,0,30,18,498,0.42857142857142855,1.1489850631941785,"(3.999, 24.0]",Q1
36031,2020-05-06,37300,23,0,30,15,513,0.2857142857142857,0.7659900421294522,"(3.999, 24.0]",Q1
36031,2020-05-07,37300,23,1,31,69,582,0.42857142857142855,1.1489850631941785,"(3.999, 24.0]",Q1
36031,2020-05-08,37300,23,0,31,64,646,0.42857142857142855,1.1489850631941785,"(3.999, 24.0]",Q1
36031,2020-05-09,37300,23,1,32,111,757,0.42857142857142855,1.1489850631941785,"(3.999, 24.0]",Q1
36031,2020-05-10,37300,23,0,32,31,788,0.42857142857142855,1.1489850631941785,"(3.999, 24.0]",Q1
36031,2020-05-11,37300,23,0,32,12,800,0.2857142857142857,0.7659900421294522,"(3.999, 24.0]",Q1
36031,2020-05-12,37300,23,0,32,77,877,0.2857142857142857,0.7659900421294522,"(3.999, 24.0]",Q1
36031,2020-05-13,37300,23,0,32,60,937,0.2857142857142857,0.7659900421294522,"(3.999, 24.0]",Q1
36031,2020-05-14,37300,23,0,32,34,971,0.14285714285714285,0.3829950210647261,"(3.999, 24.0]",Q1
36031,2020-05-15,37300,23,0,32,173,1144,0.14285714285714285,0.3829950210647261,"(3.999, 24.0]",Q1
36031,2020-05-16,37300,23,1,33,146,1290,0.14285714285714285,0.3829950210647261,"(3.999, 24.0]",Q1
36031,2020-05-17,37300,23,0,33,161,1451,0.14285714285714285,0.3829950210647261,"(3.999, 24.0]",Q1
36031,2020-05-18,37300,23,1,34,16,1467,0.2857142857142857,0.7659900421294522,"(3.999, 24.0]",Q1
36031,2020-05-19,37300,23,0,34,43,1510,0.2857142857142857,0.7659900421294522,"(3.999, 24.0]",Q1
36031,2020-05-20,37300,23,2,36,162,1672,0.5714285714285714,1.5319800842589044,"(3.999, 24.0]",Q1
36031,2020-05-21,37300,23,0,36,115,1787,0.5714285714285714,1.5319800842589044,"(3.999, 24.0]",Q1
36031,2020-05-22,37300,23,0,36,89,1876,0.5714285714285714,1.5319800842589044,"(3.999, 24.0]",Q1
36031,2020-05-23,37300,23,0,36,182,2058,0.42857142857142855,1.1489850631941785,"(3.999, 24.0]",Q1
36031,2020-05-24,37300,23,0,36,88,2146,0.42857142857142855,1.1489850631941785,"(3.999, 24.0]",Q1
36031,2020-05-25,37300,23,0,36,68,2214,0.2857142857142857,0.7659900421294522,"(3.999, 24.0]",Q1
36031,2020-05-26,37300,23,0,36,71,2285,0.2857142857142857,0.7659900421294522,"(3.999, 24.0]",Q1
36031,2020-05-27,37300,23,0,36,85,2370,0.0,0.0,"(3.999, 24.0]",Q1
36031,2020-05-28,37300,23,0,36,151,2521,0.0,0.0,"(3.999, 24.0]",Q1
36031,2020-05-29,37300,23,0,36,95,2616,0.0,0.0,"(3.999, 24.0]",Q1
36031,2020-05-30,37300,23,1,37,258,2874,0.14285714285714285,0.3829950210647261,"(3.999, 24.0]",Q1
36031,2020-05-31,37300,23,0,37,144,3018,0.14285714285714285,0.3829950210647261,"(3.999, 24.0]",Q1
36031,2020-06-01,37300,23,1,38,64,3082,0.2857142857142857,0.7659900421294522,"(3.999, 24.0]",Q1
36031,2020-06-02,37300,23,0,38,109,3191,0.2857142857142857,0.7659900421294522,"(3.999, 24.0]",Q1
36031,2020-06-03,37300,23,0,38,193,3384,0.2857142857142857,0.7659900421294522,"(3.999, 24.0]",Q1
36031,2020-06-04,37300,23,0,38,106,3490,0.2857142857142857,0.7659900421294522,"(3.999, 24.0]",Q1
36031,2020-06-05,37300,23,0,38,96,3586,0.2857142857142857,0.7659900421294522,"(3.999, 24.0]",Q1
36031,2020-06-06,37300,23,0,38,178,3764,0.14285714285714285,0.3829950210647261,"(3.999, 24.0]",Q1
36031,2020-06-07,37300,23,1,39,160,3924,0.2857142857142857,0.7659900421294522,"(3.999, 24.0]",Q1
36033,2020-03-02,50293,68,0,0,0,0,0.0,0.0,"(52.0, 100.0]",Q4
36033,2020-03-03,50293,68,0,0,0,0,0.0,0.0,"(52.0, 100.0]",Q4
36033,2020-03-04,50293,68,0,0,0,0,0.0,0.0,"(52.0, 100.0]",Q4
36033,2020-03-05,50293,68,0,0,0,0,0.0,0.0,"(52.0, 100.0]",Q4
36033,2020-03-06,50293,68,0,0,0,0,0.0,0.0,"(52.0, 100.0]",Q4
36033,2020-03-07,50293,68,0,0,0,0,0.0,0.0,"(52.0, 100.0]",Q4
36033,2020-03-08,50293,68,0,0,0,0,0.0,0.0,"(52.0, 100.0]",Q4
36033,2020-03-09,50293,68,0,0,0,0,0.0,0.0,"(52.0, 100.0]",Q4
36033,2020-03-10,50293,68,0,0,0,0,0.0,0.0,"(52.0, 100.0]",Q4
36033,2020-03-11,50293,68,0,0,0,0,0.0,0.0,"(52.0, 100.0]",Q4
36033,2020-03-12,50293,68,0,0,1,1,0.0,0.0,"(52.0, 100.0]",Q4
36033,2020-03-13,50293,68,0,0,0,1,0.0,0.0,"(52.0, 100.0]",Q4
36033,2020-03-14,50293,68,0,0,1,2,0.0,0.0,"(52.0, 100.0]",Q4
36033,2020-03-15,50293,68,0,0,0,2,0.0,0.0,"(52.0, 100.0]",Q4
36033,2020-03-16,50293,68,0,0,3,5,0.0,0.0,"(52.0, 100.0]",Q4
36033,2020-03-17,50293,68,0,0,1,6,0.0,0.0,"(52.0, 100.0]",Q4
36033,2020-03-18,50293,68,0,0,5,11,0.0,0.0,"(52.0, 100.0]",Q4
36033,2020-03-19,50293,68,0,0,6,17,0.0,0.0,"(52.0, 100.0]",Q4
36033,2020-03-20,50293,68,0,0,5,22,0.0,0.0,"(52.0, 100.0]",Q4
36033,2020-03-21,50293,68,0,0,10,32,0.0,0.0,"(52.0, 100.0]",Q4
36033,2020-03-22,50293,68,0,0,8,40,0.0,0.0,"(52.0, 100.0]",Q4
36033,2020-03-23,50293,68,0,0,3,43,0.0,0.0,"(52.0, 100.0]",Q4
36033,2020-03-24,50293,68,1,1,4,47,0.14285714285714285,0.2840497541549378,"(52.0, 100.0]",Q4
36033,2020-03-25,50293,68,0,1,5,52,0.14285714285714285,0.2840497541549378,"(52.0, 100.0]",Q4
36033,2020-03-26,50293,68,1,2,11,63,0.2857142857142857,0.5680995083098755,"(52.0, 100.0]",Q4
36033,2020-03-27,50293,68,2,4,10,73,0.5714285714285714,1.136199016619751,"(52.0, 100.0]",Q4
36033,2020-03-28,50293,68,2,6,9,82,0.8571428571428571,1.7042985249296265,"(52.0, 100.0]",Q4
36033,2020-03-29,50293,68,0,6,14,96,0.8571428571428571,1.7042985249296265,"(52.0, 100.0]",Q4
36033,2020-03-30,50293,68,3,9,10,106,1.2857142857142858,2.5564477873944402,"(52.0, 100.0]",Q4
36033,2020-03-31,50293,68,0,9,9,115,1.1428571428571428,2.272398033239502,"(52.0, 100.0]",Q4
36033,2020-04-01,50293,68,0,9,8,123,1.1428571428571428,2.272398033239502,"(52.0, 100.0]",Q4
36033,2020-04-02,50293,68,1,10,19,142,1.1428571428571428,2.272398033239502,"(52.0, 100.0]",Q4
36033,2020-04-03,50293,68,0,10,4,146,0.8571428571428571,1.7042985249296265,"(52.0, 100.0]",Q4
36033,2020-04-04,50293,68,0,10,6,152,0.5714285714285714,1.136199016619751,"(52.0, 100.0]",Q4
36033,2020-04-05,50293,68,0,10,5,157,0.5714285714285714,1.136199016619751,"(52.0, 100.0]",Q4
36033,2020-04-06,50293,68,0,10,5,162,0.14285714285714285,0.2840497541549378,"(52.0, 100.0]",Q4
36033,2020-04-07,50293,68,0,10,7,169,0.14285714285714285,0.2840497541549378,"(52.0, 100.0]",Q4
36033,2020-04-08,50293,68,1,11,5,174,0.2857142857142857,0.5680995083098755,"(52.0, 100.0]",Q4
36033,2020-04-09,50293,68,0,11,6,180,0.14285714285714285,0.2840497541549378,"(52.0, 100.0]",Q4
36033,2020-04-10,50293,68,0,11,5,185,0.14285714285714285,0.2840497541549378,"(52.0, 100.0]",Q4
36033,2020-04-11,50293,68,1,12,8,193,0.2857142857142857,0.5680995083098755,"(52.0, 100.0]",Q4
36033,2020-04-12,50293,68,0,12,6,199,0.2857142857142857,0.5680995083098755,"(52.0, 100.0]",Q4
36033,2020-04-13,50293,68,1,13,13,212,0.42857142857142855,0.8521492624648133,"(52.0, 100.0]",Q4
36033,2020-04-14,50293,68,0,13,4,216,0.42857142857142855,0.8521492624648133,"(52.0, 100.0]",Q4
36033,2020-04-15,50293,68,0,13,11,227,0.2857142857142857,0.5680995083098755,"(52.0, 100.0]",Q4
36033,2020-04-16,50293,68,0,13,3,230,0.2857142857142857,0.5680995083098755,"(52.0, 100.0]",Q4
36033,2020-04-17,50293,68,0,13,9,239,0.2857142857142857,0.5680995083098755,"(52.0, 100.0]",Q4
36033,2020-04-18,50293,68,0,13,9,248,0.14285714285714285,0.2840497541549378,"(52.0, 100.0]",Q4
36033,2020-04-19,50293,68,0,13,5,253,0.14285714285714285,0.2840497541549378,"(52.0, 100.0]",Q4
36033,2020-04-20,50293,68,0,13,3,256,0.0,0.0,"(52.0, 100.0]",Q4
36033,2020-04-21,50293,68,0,13,2,258,0.0,0.0,"(52.0, 100.0]",Q4
36033,2020-04-22,50293,68,0,13,8,266,0.0,0.0,"(52.0, 100.0]",Q4
36033,2020-04-23,50293,68,0,13,9,275,0.0,0.0,"(52.0, 100.0]",Q4
36033,2020-04-24,50293,68,1,14,35,310,0.14285714285714285,0.2840497541549378,"(52.0, 100.0]",Q4
36033,2020-04-25,50293,68,0,14,3,313,0.14285714285714285,0.2840497541549378,"(52.0, 100.0]",Q4
36033,2020-04-26,50293,68,0,14,17,330,0.14285714285714285,0.2840497541549378,"(52.0, 100.0]",Q4
36033,2020-04-27,50293,68,0,14,13,343,0.14285714285714285,0.2840497541549378,"(52.0, 100.0]",Q4
36033,2020-04-28,50293,68,1,15,17,360,0.2857142857142857,0.5680995083098755,"(52.0, 100.0]",Q4
36033,2020-04-29,50293,68,0,15,14,374,0.2857142857142857,0.5680995083098755,"(52.0, 100.0]",Q4
36033,2020-04-30,50293,68,0,15,16,390,0.2857142857142857,0.5680995083098755,"(52.0, 100.0]",Q4
36033,2020-05-01,50293,68,0,15,9,399,0.14285714285714285,0.2840497541549378,"(52.0, 100.0]",Q4
36033,2020-05-02,50293,68,0,15,9,408,0.14285714285714285,0.2840497541549378,"(52.0, 100.0]",Q4
36033,2020-05-03,50293,68,1,16,15,423,0.2857142857142857,0.5680995083098755,"(52.0, 100.0]",Q4
36033,2020-05-04,50293,68,0,16,11,434,0.2857142857142857,0.5680995083098755,"(52.0, 100.0]",Q4
36033,2020-05-05,50293,68,0,16,15,449,0.14285714285714285,0.2840497541549378,"(52.0, 100.0]",Q4
36033,2020-05-06,50293,68,0,16,18,467,0.14285714285714285,0.2840497541549378,"(52.0, 100.0]",Q4
36033,2020-05-07,50293,68,1,17,82,549,0.2857142857142857,0.5680995083098755,"(52.0, 100.0]",Q4
36033,2020-05-08,50293,68,0,17,24,573,0.2857142857142857,0.5680995083098755,"(52.0, 100.0]",Q4
36033,2020-05-09,50293,68,0,17,50,623,0.2857142857142857,0.5680995083098755,"(52.0, 100.0]",Q4
36033,2020-05-10,50293,68,0,17,53,676,0.14285714285714285,0.2840497541549378,"(52.0, 100.0]",Q4
36033,2020-05-11,50293,68,0,17,91,767,0.14285714285714285,0.2840497541549378,"(52.0, 100.0]",Q4
36033,2020-05-12,50293,68,0,17,52,819,0.14285714285714285,0.2840497541549378,"(52.0, 100.0]",Q4
36033,2020-05-13,50293,68,0,17,56,875,0.14285714285714285,0.2840497541549378,"(52.0, 100.0]",Q4
36033,2020-05-14,50293,68,0,17,48,923,0.0,0.0,"(52.0, 100.0]",Q4
36033,2020-05-15,50293,68,1,18,196,1119,0.14285714285714285,0.2840497541549378,"(52.0, 100.0]",Q4
36033,2020-05-16,50293,68,0,18,126,1245,0.14285714285714285,0.2840497541549378,"(52.0, 100.0]",Q4
36033,2020-05-17,50293,68,0,18,285,1530,0.14285714285714285,0.2840497541549378,"(52.0, 100.0]",Q4
36033,2020-05-18,50293,68,0,18,9,1539,0.14285714285714285,0.2840497541549378,"(52.0, 100.0]",Q4
36033,2020-05-19,50293,68,0,18,55,1594,0.14285714285714285,0.2840497541549378,"(52.0, 100.0]",Q4
36033,2020-05-20,50293,68,1,19,245,1839,0.2857142857142857,0.5680995083098755,"(52.0, 100.0]",Q4
36033,2020-05-21,50293,68,0,19,194,2033,0.2857142857142857,0.5680995083098755,"(52.0, 100.0]",Q4
36033,2020-05-22,50293,68,1,20,83,2116,0.2857142857142857,0.5680995083098755,"(52.0, 100.0]",Q4
36033,2020-05-23,50293,68,0,20,178,2294,0.2857142857142857,0.5680995083098755,"(52.0, 100.0]",Q4
36033,2020-05-24,50293,68,0,20,138,2432,0.2857142857142857,0.5680995083098755,"(52.0, 100.0]",Q4
36033,2020-05-25,50293,68,0,20,219,2651,0.2857142857142857,0.5680995083098755,"(52.0, 100.0]",Q4
36033,2020-05-26,50293,68,0,20,84,2735,0.2857142857142857,0.5680995083098755,"(52.0, 100.0]",Q4
36033,2020-05-27,50293,68,0,20,157,2892,0.14285714285714285,0.2840497541549378,"(52.0, 100.0]",Q4
36033,2020-05-28,50293,68,1,21,118,3010,0.2857142857142857,0.5680995083098755,"(52.0, 100.0]",Q4
36033,2020-05-29,50293,68,1,22,129,3139,0.2857142857142857,0.5680995083098755,"(52.0, 100.0]",Q4
36033,2020-05-30,50293,68,0,22,151,3290,0.2857142857142857,0.5680995083098755,"(52.0, 100.0]",Q4
36033,2020-05-31,50293,68,1,23,167,3457,0.42857142857142855,0.8521492624648133,"(52.0, 100.0]",Q4
36033,2020-06-01,50293,68,0,23,42,3499,0.42857142857142855,0.8521492624648133,"(52.0, 100.0]",Q4
36033,2020-06-02,50293,68,0,23,222,3721,0.42857142857142855,0.8521492624648133,"(52.0, 100.0]",Q4
36033,2020-06-03,50293,68,0,23,262,3983,0.42857142857142855,0.8521492624648133,"(52.0, 100.0]",Q4
36033,2020-06-04,50293,68,0,23,120,4103,0.2857142857142857,0.5680995083098755,"(52.0, 100.0]",Q4
36033,2020-06-05,50293,68,0,23,207,4310,0.14285714285714285,0.2840497541549378,"(52.0, 100.0]",Q4
36033,2020-06-06,50293,68,0,23,198,4508,0.14285714285714285,0.2840497541549378,"(52.0, 100.0]",Q4
36033,2020-06-07,50293,68,0,23,272,4780,0.0,0.0,"(52.0, 100.0]",Q4
36035,2020-03-02,53591,54,0,0,0,0,0.0,0.0,"(52.0, 100.0]",Q4
36035,2020-03-03,53591,54,0,0,0,0,0.0,0.0,"(52.0, 100.0]",Q4
36035,2020-03-04,53591,54,0,0,0,0,0.0,0.0,"(52.0, 100.0]",Q4
36035,2020-03-05,53591,54,0,0,0,0,0.0,0.0,"(52.0, 100.0]",Q4
36035,2020-03-06,53591,54,0,0,0,0,0.0,0.0,"(52.0, 100.0]",Q4
36035,2020-03-07,53591,54,0,0,0,0,0.0,0.0,"(52.0, 100.0]",Q4
36035,2020-03-08,53591,54,0,0,0,0,0.0,0.0,"(52.0, 100.0]",Q4
36035,2020-03-09,53591,54,0,0,1,1,0.0,0.0,"(52.0, 100.0]",Q4
36035,2020-03-10,53591,54,0,0,1,2,0.0,0.0,"(52.0, 100.0]",Q4
36035,2020-03-11,53591,54,0,0,2,4,0.0,0.0,"(52.0, 100.0]",Q4
36035,2020-03-12,53591,54,0,0,1,5,0.0,0.0,"(52.0, 100.0]",Q4
36035,2020-03-13,53591,54,0,0,1,6,0.0,0.0,"(52.0, 100.0]",Q4
36035,2020-03-14,53591,54,0,0,4,10,0.0,0.0,"(52.0, 100.0]",Q4
36035,2020-03-15,53591,54,0,0,1,11,0.0,0.0,"(52.0, 100.0]",Q4
36035,2020-03-16,53591,54,0,0,1,12,0.0,0.0,"(52.0, 100.0]",Q4
36035,2020-03-17,53591,54,0,0,0,12,0.0,0.0,"(52.0, 100.0]",Q4
36035,2020-03-18,53591,54,1,1,12,24,0.14285714285714285,0.2665692800230316,"(52.0, 100.0]",Q4
36035,2020-03-19,53591,54,0,1,6,30,0.14285714285714285,0.2665692800230316,"(52.0, 100.0]",Q4
36035,2020-03-20,53591,54,0,1,13,43,0.14285714285714285,0.2665692800230316,"(52.0, 100.0]",Q4
36035,2020-03-21,53591,54,0,1,11,54,0.14285714285714285,0.2665692800230316,"(52.0, 100.0]",Q4
36035,2020-03-22,53591,54,0,1,11,65,0.14285714285714285,0.2665692800230316,"(52.0, 100.0]",Q4
36035,2020-03-23,53591,54,0,1,11,76,0.14285714285714285,0.2665692800230316,"(52.0, 100.0]",Q4
36035,2020-03-24,53591,54,0,1,4,80,0.14285714285714285,0.2665692800230316,"(52.0, 100.0]",Q4
36035,2020-03-25,53591,54,0,1,2,82,0.0,0.0,"(52.0, 100.0]",Q4
36035,2020-03-26,53591,54,0,1,5,87,0.0,0.0,"(52.0, 100.0]",Q4
36035,2020-03-27,53591,54,0,1,10,97,0.0,0.0,"(52.0, 100.0]",Q4
36035,2020-03-28,53591,54,0,1,10,107,0.0,0.0,"(52.0, 100.0]",Q4
36035,2020-03-29,53591,54,0,1,12,119,0.0,0.0,"(52.0, 100.0]",Q4
36035,2020-03-30,53591,54,0,1,5,124,0.0,0.0,"(52.0, 100.0]",Q4
36035,2020-03-31,53591,54,1,2,5,129,0.14285714285714285,0.2665692800230316,"(52.0, 100.0]",Q4
36035,2020-04-01,53591,54,4,6,10,139,0.7142857142857143,1.3328464001151579,"(52.0, 100.0]",Q4
36035,2020-04-02,53591,54,0,6,10,149,0.7142857142857143,1.3328464001151579,"(52.0, 100.0]",Q4
36035,2020-04-03,53591,54,3,9,24,173,1.1428571428571428,2.1325542401842528,"(52.0, 100.0]",Q4
36035,2020-04-04,53591,54,0,9,12,185,1.1428571428571428,2.1325542401842528,"(52.0, 100.0]",Q4
36035,2020-04-05,53591,54,2,11,20,205,1.4285714285714286,2.6656928002303157,"(52.0, 100.0]",Q4
36035,2020-04-06,53591,54,2,13,18,223,1.7142857142857142,3.1988313602763787,"(52.0, 100.0]",Q4
36035,2020-04-07,53591,54,1,14,6,229,1.7142857142857142,3.1988313602763787,"(52.0, 100.0]",Q4
36035,2020-04-08,53591,54,1,15,21,250,1.2857142857142858,2.3991235202072847,"(52.0, 100.0]",Q4
36035,2020-04-09,53591,54,3,18,24,274,1.7142857142857142,3.1988313602763787,"(52.0, 100.0]",Q4
36035,2020-04-10,53591,54,3,21,17,291,1.7142857142857142,3.1988313602763787,"(52.0, 100.0]",Q4
36035,2020-04-11,53591,54,0,21,11,302,1.7142857142857142,3.1988313602763787,"(52.0, 100.0]",Q4
36035,2020-04-12,53591,54,0,21,7,309,1.4285714285714286,2.6656928002303157,"(52.0, 100.0]",Q4
36035,2020-04-13,53591,54,1,22,75,384,1.2857142857142858,2.3991235202072847,"(52.0, 100.0]",Q4
36035,2020-04-14,53591,54,2,24,9,393,1.4285714285714286,2.6656928002303157,"(52.0, 100.0]",Q4
36035,2020-04-15,53591,54,1,25,13,406,1.4285714285714286,2.6656928002303157,"(52.0, 100.0]",Q4
36035,2020-04-16,53591,54,2,27,16,422,1.2857142857142858,2.3991235202072847,"(52.0, 100.0]",Q4
36035,2020-04-17,53591,54,0,27,7,429,0.8571428571428571,1.5994156801381894,"(52.0, 100.0]",Q4
36035,2020-04-18,53591,54,0,27,17,446,0.8571428571428571,1.5994156801381894,"(52.0, 100.0]",Q4
36035,2020-04-19,53591,54,0,27,3,449,0.8571428571428571,1.5994156801381894,"(52.0, 100.0]",Q4
36035,2020-04-20,53591,54,0,27,4,453,0.7142857142857143,1.3328464001151579,"(52.0, 100.0]",Q4
36035,2020-04-21,53591,54,1,28,7,460,0.5714285714285714,1.0662771200921264,"(52.0, 100.0]",Q4
36035,2020-04-22,53591,54,0,28,5,465,0.42857142857142855,0.7997078400690947,"(52.0, 100.0]",Q4
36035,2020-04-23,53591,54,1,29,16,481,0.2857142857142857,0.5331385600460632,"(52.0, 100.0]",Q4
36035,2020-04-24,53591,54,32,61,202,683,4.857142857142857,9.063355520783073,"(52.0, 100.0]",Q4
36035,2020-04-25,53591,54,1,62,29,712,5.0,9.329924800806106,"(52.0, 100.0]",Q4
36035,2020-04-26,53591,54,0,62,9,721,5.0,9.329924800806106,"(52.0, 100.0]",Q4
36035,2020-04-27,53591,54,4,66,16,737,5.571428571428571,10.396201920898232,"(52.0, 100.0]",Q4
36035,2020-04-28,53591,54,1,67,27,764,5.571428571428571,10.396201920898232,"(52.0, 100.0]",Q4
36035,2020-04-29,53591,54,4,71,27,791,6.142857142857143,11.46247904099036,"(52.0, 100.0]",Q4
36035,2020-04-30,53591,54,4,75,37,828,6.571428571428571,12.262186881059451,"(52.0, 100.0]",Q4
36035,2020-05-01,53591,54,4,79,34,862,2.5714285714285716,4.798247040414569,"(52.0, 100.0]",Q4
36035,2020-05-02,53591,54,3,82,36,898,2.857142857142857,5.3313856004606315,"(52.0, 100.0]",Q4
36035,2020-05-03,53591,54,2,84,25,923,3.142857142857143,5.8645241605066945,"(52.0, 100.0]",Q4
36035,2020-05-04,53591,54,13,97,63,986,4.428571428571429,8.263647680713978,"(52.0, 100.0]",Q4
36035,2020-05-05,53591,54,3,100,50,1036,4.714285714285714,8.796786240760044,"(52.0, 100.0]",Q4
36035,2020-05-06,53591,54,1,101,30,1066,4.285714285714286,7.997078400690948,"(52.0, 100.0]",Q4
36035,2020-05-07,53591,54,2,103,27,1093,4.0,7.463939840644883,"(52.0, 100.0]",Q4
36035,2020-05-08,53591,54,1,104,30,1123,3.5714285714285716,6.66423200057579,"(52.0, 100.0]",Q4
36035,2020-05-09,53591,54,3,107,31,1154,3.5714285714285716,6.66423200057579,"(52.0, 100.0]",Q4
36035,2020-05-10,53591,54,2,109,59,1213,3.5714285714285716,6.66423200057579,"(52.0, 100.0]",Q4
36035,2020-05-11,53591,54,26,135,100,1313,5.428571428571429,10.1296326408752,"(52.0, 100.0]",Q4
36035,2020-05-12,53591,54,5,140,61,1374,5.714285714285714,10.662771200921263,"(52.0, 100.0]",Q4
36035,2020-05-13,53591,54,4,144,81,1455,6.142857142857143,11.46247904099036,"(52.0, 100.0]",Q4
36035,2020-05-14,53591,54,1,145,67,1522,6.0,11.195909760967327,"(52.0, 100.0]",Q4
36035,2020-05-15,53591,54,3,148,100,1622,6.285714285714286,11.729048321013389,"(52.0, 100.0]",Q4
36035,2020-05-16,53591,54,23,171,110,1732,9.142857142857142,17.060433921474022,"(52.0, 100.0]",Q4
36035,2020-05-17,53591,54,11,182,132,1864,10.428571428571429,19.459557441681305,"(52.0, 100.0]",Q4
36035,2020-05-18,53591,54,0,182,30,1894,6.714285714285714,12.528756161082484,"(52.0, 100.0]",Q4
36035,2020-05-19,53591,54,2,184,89,1983,6.285714285714286,11.729048321013389,"(52.0, 100.0]",Q4
36035,2020-05-20,53591,54,2,186,100,2083,6.0,11.195909760967327,"(52.0, 100.0]",Q4
36035,2020-05-21,53591,54,3,189,88,2171,6.285714285714286,11.729048321013389,"(52.0, 100.0]",Q4
36035,2020-05-22,53591,54,4,193,142,2313,6.428571428571429,11.995617601036422,"(52.0, 100.0]",Q4
36035,2020-05-23,53591,54,1,194,84,2397,3.2857142857142856,6.1310934405297255,"(52.0, 100.0]",Q4
36035,2020-05-24,53591,54,2,196,86,2483,2.0,3.7319699203224417,"(52.0, 100.0]",Q4
36035,2020-05-25,53591,54,0,196,44,2527,2.0,3.7319699203224417,"(52.0, 100.0]",Q4
36035,2020-05-26,53591,54,2,198,112,2639,2.0,3.7319699203224417,"(52.0, 100.0]",Q4
36035,2020-05-27,53591,54,2,200,223,2862,2.0,3.7319699203224417,"(52.0, 100.0]",Q4
36035,2020-05-28,53591,54,6,206,202,3064,2.4285714285714284,4.531677760391537,"(52.0, 100.0]",Q4
36035,2020-05-29,53591,54,1,207,146,3210,2.0,3.7319699203224417,"(52.0, 100.0]",Q4
36035,2020-05-30,53591,54,1,208,159,3369,2.0,3.7319699203224417,"(52.0, 100.0]",Q4
36035,2020-05-31,53591,54,2,210,169,3538,2.0,3.7319699203224417,"(52.0, 100.0]",Q4
36035,2020-06-01,53591,54,2,212,83,3621,2.2857142857142856,4.2651084803685055,"(52.0, 100.0]",Q4
36035,2020-06-02,53591,54,1,213,197,3818,2.142857142857143,3.998539200345474,"(52.0, 100.0]",Q4
36035,2020-06-03,53591,54,2,215,187,4005,2.142857142857143,3.998539200345474,"(52.0, 100.0]",Q4
36035,2020-06-04,53591,54,4,219,248,4253,1.8571428571428572,3.4654006402994106,"(52.0, 100.0]",Q4
36035,2020-06-05,53591,54,3,222,233,4486,2.142857142857143,3.998539200345474,"(52.0, 100.0]",Q4
36035,2020-06-06,53591,54,2,224,205,4691,2.2857142857142856,4.2651084803685055,"(52.0, 100.0]",Q4
36035,2020-06-07,53591,54,3,227,254,4945,2.4285714285714284,4.531677760391537,"(52.0, 100.0]",Q4
36037,2020-03-02,57511,22,0,0,0,0,0.0,0.0,"(3.999, 24.0]",Q1
36037,2020-03-03,57511,22,0,0,0,0,0.0,0.0,"(3.999, 24.0]",Q1
36037,2020-03-04,57511,22,0,0,0,0,0.0,0.0,"(3.999, 24.0]",Q1
36037,2020-03-05,57511,22,0,0,0,0,0.0,0.0,"(3.999, 24.0]",Q1
36037,2020-03-06,57511,22,0,0,0,0,0.0,0.0,"(3.999, 24.0]",Q1
36037,2020-03-07,57511,22,0,0,0,0,0.0,0.0,"(3.999, 24.0]",Q1
36037,2020-03-08,57511,22,0,0,0,0,0.0,0.0,"(3.999, 24.0]",Q1
36037,2020-03-09,57511,22,0,0,0,0,0.0,0.0,"(3.999, 24.0]",Q1
36037,2020-03-10,57511,22,0,0,1,1,0.0,0.0,"(3.999, 24.0]",Q1
36037,2020-03-11,57511,22,0,0,0,1,0.0,0.0,"(3.999, 24.0]",Q1
36037,2020-03-12,57511,22,0,0,0,1,0.0,0.0,"(3.999, 24.0]",Q1
36037,2020-03-13,57511,22,0,0,0,1,0.0,0.0,"(3.999, 24.0]",Q1
36037,2020-03-14,57511,22,0,0,0,1,0.0,0.0,"(3.999, 24.0]",Q1
36037,2020-03-15,57511,22,0,0,0,1,0.0,0.0,"(3.999, 24.0]",Q1
36037,2020-03-16,57511,22,0,0,3,4,0.0,0.0,"(3.999, 24.0]",Q1
36037,2020-03-17,57511,22,0,0,5,9,0.0,0.0,"(3.999, 24.0]",Q1
36037,2020-03-18,57511,22,1,1,9,18,0.14285714285714285,0.24839968502919935,"(3.999, 24.0]",Q1
36037,2020-03-19,57511,22,0,1,6,24,0.14285714285714285,0.24839968502919935,"(3.999, 24.0]",Q1
36037,2020-03-20,57511,22,0,1,6,30,0.14285714285714285,0.24839968502919935,"(3.999, 24.0]",Q1
36037,2020-03-21,57511,22,0,1,6,36,0.14285714285714285,0.24839968502919935,"(3.999, 24.0]",Q1
36037,2020-03-22,57511,22,0,1,2,38,0.14285714285714285,0.24839968502919935,"(3.999, 24.0]",Q1
36037,2020-03-23,57511,22,0,1,8,46,0.14285714285714285,0.24839968502919935,"(3.999, 24.0]",Q1
36037,2020-03-24,57511,22,1,2,7,53,0.2857142857142857,0.4967993700583987,"(3.999, 24.0]",Q1
36037,2020-03-25,57511,22,2,4,19,72,0.42857142857142855,0.7451990550875981,"(3.999, 24.0]",Q1
36037,2020-03-26,57511,22,2,6,21,93,0.7142857142857143,1.241998425145997,"(3.999, 24.0]",Q1
36037,2020-03-27,57511,22,1,7,19,112,0.8571428571428571,1.4903981101751962,"(3.999, 24.0]",Q1
36037,2020-03-28,57511,22,2,9,6,118,1.1428571428571428,1.9871974802335948,"(3.999, 24.0]",Q1
36037,2020-03-29,57511,22,0,9,12,130,1.1428571428571428,1.9871974802335948,"(3.999, 24.0]",Q1
36037,2020-03-30,57511,22,1,10,24,154,1.2857142857142858,2.235597165262795,"(3.999, 24.0]",Q1
36037,2020-03-31,57511,22,3,13,28,182,1.5714285714285714,2.732396535321193,"(3.999, 24.0]",Q1
36037,2020-04-01,57511,22,1,14,39,221,1.4285714285714286,2.483996850291994,"(3.999, 24.0]",Q1
36037,2020-04-02,57511,22,2,16,23,244,1.4285714285714286,2.483996850291994,"(3.999, 24.0]",Q1
36037,2020-04-03,57511,22,4,20,30,274,1.8571428571428572,3.229195905379592,"(3.999, 24.0]",Q1
36037,2020-04-04,57511,22,2,22,12,286,1.8571428571428572,3.229195905379592,"(3.999, 24.0]",Q1
36037,2020-04-05,57511,22,1,23,11,297,2.0,3.477595590408791,"(3.999, 24.0]",Q1
36037,2020-04-06,57511,22,10,33,37,334,3.2857142857142856,5.713192755671585,"(3.999, 24.0]",Q1
36037,2020-04-07,57511,22,14,47,31,365,4.857142857142857,8.445589290992778,"(3.999, 24.0]",Q1
36037,2020-04-08,57511,22,9,56,43,408,6.0,10.432786771226374,"(3.999, 24.0]",Q1
36037,2020-04-09,57511,22,9,65,32,440,7.0,12.17158456643077,"(3.999, 24.0]",Q1
36037,2020-04-10,57511,22,2,67,18,458,6.714285714285714,11.67478519637237,"(3.999, 24.0]",Q1
36037,2020-04-11,57511,22,2,69,19,477,6.714285714285714,11.67478519637237,"(3.999, 24.0]",Q1
36037,2020-04-12,57511,22,2,71,7,484,6.857142857142857,11.92318488140157,"(3.999, 24.0]",Q1
36037,2020-04-13,57511,22,5,76,34,518,6.142857142857143,10.681186456255574,"(3.999, 24.0]",Q1
36037,2020-04-14,57511,22,0,76,15,533,4.142857142857143,7.203590865846783,"(3.999, 24.0]",Q1
36037,2020-04-15,57511,22,2,78,12,545,3.142857142857143,5.464793070642386,"(3.999, 24.0]",Q1
36037,2020-04-16,57511,22,5,83,21,566,2.5714285714285716,4.47119433052559,"(3.999, 24.0]",Q1
36037,2020-04-17,57511,22,4,87,13,579,2.857142857142857,4.967993700583988,"(3.999, 24.0]",Q1
36037,2020-04-18,57511,22,30,117,56,635,6.857142857142857,11.92318488140157,"(3.999, 24.0]",Q1
36037,2020-04-19,57511,22,2,119,14,649,6.857142857142857,11.92318488140157,"(3.999, 24.0]",Q1
36037,2020-04-20,57511,22,2,121,8,657,6.428571428571429,11.177985826313973,"(3.999, 24.0]",Q1
36037,2020-04-21,57511,22,1,122,17,674,6.571428571428571,11.42638551134317,"(3.999, 24.0]",Q1
36037,2020-04-22,57511,22,4,126,25,699,6.857142857142857,11.92318488140157,"(3.999, 24.0]",Q1
36037,2020-04-23,57511,22,1,127,19,718,6.285714285714286,10.929586141284773,"(3.999, 24.0]",Q1
36037,2020-04-24,57511,22,14,141,145,863,7.714285714285714,13.413582991576765,"(3.999, 24.0]",Q1
36037,2020-04-25,57511,22,3,144,37,900,3.857142857142857,6.706791495788383,"(3.999, 24.0]",Q1
36037,2020-04-26,57511,22,4,148,20,920,4.142857142857143,7.203590865846783,"(3.999, 24.0]",Q1
36037,2020-04-27,57511,22,1,149,28,948,4.0,6.955191180817582,"(3.999, 24.0]",Q1
36037,2020-04-28,57511,22,3,152,26,974,4.285714285714286,7.451990550875981,"(3.999, 24.0]",Q1
36037,2020-04-29,57511,22,1,153,32,1006,3.857142857142857,6.706791495788383,"(3.999, 24.0]",Q1
36037,2020-04-30,57511,22,1,154,29,1035,3.857142857142857,6.706791495788383,"(3.999, 24.0]",Q1
36037,2020-05-01,57511,22,1,155,55,1090,2.0,3.477595590408791,"(3.999, 24.0]",Q1
36037,2020-05-02,57511,22,0,155,25,1115,1.5714285714285714,2.732396535321193,"(3.999, 24.0]",Q1
36037,2020-05-03,57511,22,4,159,48,1163,1.5714285714285714,2.732396535321193,"(3.999, 24.0]",Q1
36037,2020-05-04,57511,22,0,159,47,1210,1.4285714285714286,2.483996850291994,"(3.999, 24.0]",Q1
36037,2020-05-05,57511,22,3,162,59,1269,1.4285714285714286,2.483996850291994,"(3.999, 24.0]",Q1
36037,2020-05-06,57511,22,6,168,98,1367,2.142857142857143,3.7259952754379904,"(3.999, 24.0]",Q1
36037,2020-05-07,57511,22,1,169,62,1429,2.142857142857143,3.7259952754379904,"(3.999, 24.0]",Q1
36037,2020-05-08,57511,22,1,170,47,1476,2.142857142857143,3.7259952754379904,"(3.999, 24.0]",Q1
36037,2020-05-09,57511,22,2,172,149,1625,2.4285714285714284,4.222794645496389,"(3.999, 24.0]",Q1
36037,2020-05-10,57511,22,1,173,182,1807,2.0,3.477595590408791,"(3.999, 24.0]",Q1
36037,2020-05-11,57511,22,1,174,77,1884,2.142857142857143,3.7259952754379904,"(3.999, 24.0]",Q1
36037,2020-05-12,57511,22,0,174,96,1980,1.7142857142857142,2.9807962203503924,"(3.999, 24.0]",Q1
36037,2020-05-13,57511,22,1,175,77,2057,1.0,1.7387977952043956,"(3.999, 24.0]",Q1
36037,2020-05-14,57511,22,0,175,66,2123,0.8571428571428571,1.4903981101751962,"(3.999, 24.0]",Q1
36037,2020-05-15,57511,22,3,178,47,2170,1.1428571428571428,1.9871974802335948,"(3.999, 24.0]",Q1
36037,2020-05-16,57511,22,2,180,69,2239,1.1428571428571428,1.9871974802335948,"(3.999, 24.0]",Q1
36037,2020-05-17,57511,22,0,180,30,2269,1.0,1.7387977952043956,"(3.999, 24.0]",Q1
36037,2020-05-18,57511,22,2,182,77,2346,1.1428571428571428,1.9871974802335948,"(3.999, 24.0]",Q1
36037,2020-05-19,57511,22,2,184,95,2441,1.4285714285714286,2.483996850291994,"(3.999, 24.0]",Q1
36037,2020-05-20,57511,22,4,188,145,2586,1.8571428571428572,3.229195905379592,"(3.999, 24.0]",Q1
36037,2020-05-21,57511,22,1,189,42,2628,2.0,3.477595590408791,"(3.999, 24.0]",Q1
36037,2020-05-22,57511,22,2,191,271,2899,1.8571428571428572,3.229195905379592,"(3.999, 24.0]",Q1
36037,2020-05-23,57511,22,0,191,181,3080,1.5714285714285714,2.732396535321193,"(3.999, 24.0]",Q1
36037,2020-05-24,57511,22,1,192,95,3175,1.7142857142857142,2.9807962203503924,"(3.999, 24.0]",Q1
36037,2020-05-25,57511,22,1,193,58,3233,1.5714285714285714,2.732396535321193,"(3.999, 24.0]",Q1
36037,2020-05-26,57511,22,2,195,84,3317,1.5714285714285714,2.732396535321193,"(3.999, 24.0]",Q1
36037,2020-05-27,57511,22,2,197,177,3494,1.2857142857142858,2.235597165262795,"(3.999, 24.0]",Q1
36037,2020-05-28,57511,22,2,199,119,3613,1.4285714285714286,2.483996850291994,"(3.999, 24.0]",Q1
36037,2020-05-29,57511,22,1,200,135,3748,1.2857142857142858,2.235597165262795,"(3.999, 24.0]",Q1
36037,2020-05-30,57511,22,2,202,115,3863,1.5714285714285714,2.732396535321193,"(3.999, 24.0]",Q1
36037,2020-05-31,57511,22,0,202,82,3945,1.4285714285714286,2.483996850291994,"(3.999, 24.0]",Q1
36037,2020-06-01,57511,22,0,202,145,4090,1.2857142857142858,2.235597165262795,"(3.999, 24.0]",Q1
36037,2020-06-02,57511,22,0,202,264,4354,1.0,1.7387977952043956,"(3.999, 24.0]",Q1
36037,2020-06-03,57511,22,3,205,326,4680,1.1428571428571428,1.9871974802335948,"(3.999, 24.0]",Q1
36037,2020-06-04,57511,22,0,205,137,4817,0.8571428571428571,1.4903981101751962,"(3.999, 24.0]",Q1
36037,2020-06-05,57511,22,1,206,322,5139,0.8571428571428571,1.4903981101751962,"(3.999, 24.0]",Q1
36037,2020-06-06,57511,22,2,208,153,5292,0.8571428571428571,1.4903981101751962,"(3.999, 24.0]",Q1
36037,2020-06-07,57511,22,0,208,104,5396,0.8571428571428571,1.4903981101751962,"(3.999, 24.0]",Q1
36039,2020-03-02,47491,28,0,0,0,0,0.0,0.0,"(24.0, 37.5]",Q2
36039,2020-03-03,47491,28,0,0,0,0,0.0,0.0,"(24.0, 37.5]",Q2
36039,2020-03-04,47491,28,0,0,0,0,0.0,0.0,"(24.0, 37.5]",Q2
36039,2020-03-05,47491,28,0,0,0,0,0.0,0.0,"(24.0, 37.5]",Q2
36039,2020-03-06,47491,28,0,0,0,0,0.0,0.0,"(24.0, 37.5]",Q2
36039,2020-03-07,47491,28,0,0,0,0,0.0,0.0,"(24.0, 37.5]",Q2
36039,2020-03-08,47491,28,0,0,0,0,0.0,0.0,"(24.0, 37.5]",Q2
36039,2020-03-09,47491,28,0,0,0,0,0.0,0.0,"(24.0, 37.5]",Q2
36039,2020-03-10,47491,28,0,0,0,0,0.0,0.0,"(24.0, 37.5]",Q2
36039,2020-03-11,47491,28,0,0,3,3,0.0,0.0,"(24.0, 37.5]",Q2
36039,2020-03-12,47491,28,0,0,0,3,0.0,0.0,"(24.0, 37.5]",Q2
36039,2020-03-13,47491,28,0,0,1,4,0.0,0.0,"(24.0, 37.5]",Q2
36039,2020-03-14,47491,28,2,2,8,12,0.2857142857142857,0.6016177501300998,"(24.0, 37.5]",Q2
36039,2020-03-15,47491,28,0,2,3,15,0.2857142857142857,0.6016177501300998,"(24.0, 37.5]",Q2
36039,2020-03-16,47491,28,0,2,9,24,0.2857142857142857,0.6016177501300998,"(24.0, 37.5]",Q2
36039,2020-03-17,47491,28,0,2,8,32,0.2857142857142857,0.6016177501300998,"(24.0, 37.5]",Q2
36039,2020-03-18,47491,28,0,2,16,48,0.2857142857142857,0.6016177501300998,"(24.0, 37.5]",Q2
36039,2020-03-19,47491,28,0,2,21,69,0.2857142857142857,0.6016177501300998,"(24.0, 37.5]",Q2
36039,2020-03-20,47491,28,0,2,24,93,0.2857142857142857,0.6016177501300998,"(24.0, 37.5]",Q2
36039,2020-03-21,47491,28,0,2,23,116,0.0,0.0,"(24.0, 37.5]",Q2
36039,2020-03-22,47491,28,2,4,32,148,0.2857142857142857,0.6016177501300998,"(24.0, 37.5]",Q2
36039,2020-03-23,47491,28,0,4,8,156,0.2857142857142857,0.6016177501300998,"(24.0, 37.5]",Q2
36039,2020-03-24,47491,28,0,4,3,159,0.2857142857142857,0.6016177501300998,"(24.0, 37.5]",Q2
36039,2020-03-25,47491,28,1,5,11,170,0.42857142857142855,0.9024266251951496,"(24.0, 37.5]",Q2
36039,2020-03-26,47491,28,1,6,11,181,0.5714285714285714,1.2032355002601995,"(24.0, 37.5]",Q2
36039,2020-03-27,47491,28,1,7,6,187,0.7142857142857143,1.5040443753252497,"(24.0, 37.5]",Q2
36039,2020-03-28,47491,28,0,7,6,193,0.7142857142857143,1.5040443753252497,"(24.0, 37.5]",Q2
36039,2020-03-29,47491,28,3,10,13,206,0.8571428571428571,1.8048532503902992,"(24.0, 37.5]",Q2
36039,2020-03-30,47491,28,6,16,15,221,1.7142857142857142,3.6097065007805984,"(24.0, 37.5]",Q2
36039,2020-03-31,47491,28,2,18,9,230,2.0,4.211324250910699,"(24.0, 37.5]",Q2
36039,2020-04-01,47491,28,3,21,11,241,2.2857142857142856,4.812942001040798,"(24.0, 37.5]",Q2
36039,2020-04-02,47491,28,2,23,16,257,2.4285714285714284,5.113750876105849,"(24.0, 37.5]",Q2
36039,2020-04-03,47491,28,1,24,10,267,2.4285714285714284,5.113750876105849,"(24.0, 37.5]",Q2
36039,2020-04-04,47491,28,0,24,7,274,2.4285714285714284,5.113750876105849,"(24.0, 37.5]",Q2
36039,2020-04-05,47491,28,0,24,12,286,2.0,4.211324250910699,"(24.0, 37.5]",Q2
36039,2020-04-06,47491,28,0,24,13,299,1.1428571428571428,2.406471000520399,"(24.0, 37.5]",Q2
36039,2020-04-07,47491,28,1,25,6,305,1.0,2.1056621254553494,"(24.0, 37.5]",Q2
36039,2020-04-08,47491,28,3,28,29,334,1.0,2.1056621254553494,"(24.0, 37.5]",Q2
36039,2020-04-09,47491,28,6,34,36,370,1.5714285714285714,3.308897625715549,"(24.0, 37.5]",Q2
36039,2020-04-10,47491,28,3,37,27,397,1.8571428571428572,3.9105153758456495,"(24.0, 37.5]",Q2
36039,2020-04-11,47491,28,7,44,40,437,2.857142857142857,6.016177501300999,"(24.0, 37.5]",Q2
36039,2020-04-12,47491,28,1,45,14,451,3.0,6.3169863763660485,"(24.0, 37.5]",Q2
36039,2020-04-13,47491,28,21,66,93,544,6.0,12.633972752732097,"(24.0, 37.5]",Q2
36039,2020-04-14,47491,28,7,73,25,569,6.857142857142857,14.438826003122394,"(24.0, 37.5]",Q2
36039,2020-04-15,47491,28,1,74,16,585,6.571428571428571,13.837208252992298,"(24.0, 37.5]",Q2
36039,2020-04-16,47491,28,3,77,16,601,6.142857142857143,12.934781627797147,"(24.0, 37.5]",Q2
36039,2020-04-17,47491,28,5,82,28,629,6.428571428571429,13.536399377927246,"(24.0, 37.5]",Q2
36039,2020-04-18,47491,28,3,85,24,653,5.857142857142857,12.333163877667046,"(24.0, 37.5]",Q2
36039,2020-04-19,47491,28,1,86,8,661,5.857142857142857,12.333163877667046,"(24.0, 37.5]",Q2
36039,2020-04-20,47491,28,1,87,16,677,3.0,6.3169863763660485,"(24.0, 37.5]",Q2
36039,2020-04-21,47491,28,0,87,15,692,2.0,4.211324250910699,"(24.0, 37.5]",Q2
36039,2020-04-22,47491,28,2,89,25,717,2.142857142857143,4.512133125975749,"(24.0, 37.5]",Q2
36039,2020-04-23,47491,28,1,90,31,748,1.8571428571428572,3.9105153758456495,"(24.0, 37.5]",Q2
36039,2020-04-24,47491,28,17,107,212,960,3.5714285714285716,7.520221876626248,"(24.0, 37.5]",Q2
36039,2020-04-25,47491,28,3,110,36,996,3.5714285714285716,7.520221876626248,"(24.0, 37.5]",Q2
36039,2020-04-26,47491,28,1,111,25,1021,3.5714285714285716,7.520221876626248,"(24.0, 37.5]",Q2
36039,2020-04-27,47491,28,1,112,20,1041,3.5714285714285716,7.520221876626248,"(24.0, 37.5]",Q2
36039,2020-04-28,47491,28,2,114,24,1065,3.857142857142857,8.121839626756348,"(24.0, 37.5]",Q2
36039,2020-04-29,47491,28,17,131,59,1124,6.0,12.633972752732097,"(24.0, 37.5]",Q2
36039,2020-04-30,47491,28,8,139,47,1171,7.0,14.739634878187447,"(24.0, 37.5]",Q2
36039,2020-05-01,47491,28,3,142,36,1207,5.0,10.528310627276747,"(24.0, 37.5]",Q2
36039,2020-05-02,47491,28,9,151,32,1239,5.857142857142857,12.333163877667046,"(24.0, 37.5]",Q2
36039,2020-05-03,47491,28,3,154,34,1273,6.142857142857143,12.934781627797147,"(24.0, 37.5]",Q2
36039,2020-05-04,47491,28,12,166,36,1309,7.714285714285714,16.243679253512695,"(24.0, 37.5]",Q2
36039,2020-05-05,47491,28,22,188,84,1393,10.571428571428571,22.259856754813693,"(24.0, 37.5]",Q2
36039,2020-05-06,47491,28,10,198,55,1448,9.571428571428571,20.154194629358344,"(24.0, 37.5]",Q2
36039,2020-05-07,47491,28,1,199,34,1482,8.571428571428571,18.048532503902997,"(24.0, 37.5]",Q2
36039,2020-05-08,47491,28,5,204,45,1527,8.857142857142858,18.650150254033097,"(24.0, 37.5]",Q2
36039,2020-05-09,47491,28,2,206,44,1571,7.857142857142857,16.544488128577743,"(24.0, 37.5]",Q2
36039,2020-05-10,47491,28,0,206,14,1585,7.428571428571429,15.642061503382598,"(24.0, 37.5]",Q2
36039,2020-05-11,47491,28,0,206,28,1613,5.714285714285714,12.032355002601998,"(24.0, 37.5]",Q2
36039,2020-05-12,47491,28,0,206,41,1654,2.5714285714285716,5.414559751170899,"(24.0, 37.5]",Q2
36039,2020-05-13,47491,28,1,207,46,1700,1.2857142857142858,2.7072798755854497,"(24.0, 37.5]",Q2
36039,2020-05-14,47491,28,2,209,64,1764,1.4285714285714286,3.0080887506504994,"(24.0, 37.5]",Q2
36039,2020-05-15,47491,28,2,211,49,1813,1.0,2.1056621254553494,"(24.0, 37.5]",Q2
36039,2020-05-16,47491,28,1,212,43,1856,0.8571428571428571,1.8048532503902992,"(24.0, 37.5]",Q2
36039,2020-05-17,47491,28,1,213,33,1889,1.0,2.1056621254553494,"(24.0, 37.5]",Q2
36039,2020-05-18,47491,28,1,214,26,1915,1.1428571428571428,2.406471000520399,"(24.0, 37.5]",Q2
36039,2020-05-19,47491,28,1,215,189,2104,1.2857142857142858,2.7072798755854497,"(24.0, 37.5]",Q2
36039,2020-05-20,47491,28,0,215,44,2148,1.1428571428571428,2.406471000520399,"(24.0, 37.5]",Q2
36039,2020-05-21,47491,28,0,215,48,2196,0.8571428571428571,1.8048532503902992,"(24.0, 37.5]",Q2
36039,2020-05-22,47491,28,2,217,69,2265,0.8571428571428571,1.8048532503902992,"(24.0, 37.5]",Q2
36039,2020-05-23,47491,28,3,220,55,2320,1.1428571428571428,2.406471000520399,"(24.0, 37.5]",Q2
36039,2020-05-24,47491,28,5,225,35,2355,1.7142857142857142,3.6097065007805984,"(24.0, 37.5]",Q2
36039,2020-05-25,47491,28,0,225,24,2379,1.5714285714285714,3.308897625715549,"(24.0, 37.5]",Q2
36039,2020-05-26,47491,28,6,231,108,2487,2.2857142857142856,4.812942001040798,"(24.0, 37.5]",Q2
36039,2020-05-27,47491,28,5,236,107,2594,3.0,6.3169863763660485,"(24.0, 37.5]",Q2
36039,2020-05-28,47491,28,1,237,92,2686,3.142857142857143,6.617795251431098,"(24.0, 37.5]",Q2
36039,2020-05-29,47491,28,1,238,110,2796,3.0,6.3169863763660485,"(24.0, 37.5]",Q2
36039,2020-05-30,47491,28,0,238,100,2896,2.5714285714285716,5.414559751170899,"(24.0, 37.5]",Q2
36039,2020-05-31,47491,28,1,239,79,2975,2.0,4.211324250910699,"(24.0, 37.5]",Q2
36039,2020-06-01,47491,28,2,241,119,3094,2.2857142857142856,4.812942001040798,"(24.0, 37.5]",Q2
36039,2020-06-02,47491,28,0,241,153,3247,1.4285714285714286,3.0080887506504994,"(24.0, 37.5]",Q2
36039,2020-06-03,47491,28,0,241,130,3377,0.7142857142857143,1.5040443753252497,"(24.0, 37.5]",Q2
36039,2020-06-04,47491,28,1,242,134,3511,0.7142857142857143,1.5040443753252497,"(24.0, 37.5]",Q2
36039,2020-06-05,47491,28,4,246,181,3692,1.1428571428571428,2.406471000520399,"(24.0, 37.5]",Q2
36039,2020-06-06,47491,28,0,246,117,3809,1.1428571428571428,2.406471000520399,"(24.0, 37.5]",Q2
36039,2020-06-07,47491,28,1,247,42,3851,1.1428571428571428,2.406471000520399,"(24.0, 37.5]",Q2
36041,2020-03-02,4434,12,0,0,0,0,0.0,0.0,"(3.999, 24.0]",Q1
36041,2020-03-03,4434,12,0,0,0,0,0.0,0.0,"(3.999, 24.0]",Q1
36041,2020-03-04,4434,12,0,0,0,0,0.0,0.0,"(3.999, 24.0]",Q1
36041,2020-03-05,4434,12,0,0,0,0,0.0,0.0,"(3.999, 24.0]",Q1
36041,2020-03-06,4434,12,0,0,0,0,0.0,0.0,"(3.999, 24.0]",Q1
36041,2020-03-07,4434,12,0,0,0,0,0.0,0.0,"(3.999, 24.0]",Q1
36041,2020-03-08,4434,12,0,0,0,0,0.0,0.0,"(3.999, 24.0]",Q1
36041,2020-03-09,4434,12,0,0,0,0,0.0,0.0,"(3.999, 24.0]",Q1
36041,2020-03-10,4434,12,0,0,0,0,0.0,0.0,"(3.999, 24.0]",Q1
36041,2020-03-11,4434,12,0,0,0,0,0.0,0.0,"(3.999, 24.0]",Q1
36041,2020-03-12,4434,12,0,0,0,0,0.0,0.0,"(3.999, 24.0]",Q1
36041,2020-03-13,4434,12,0,0,0,0,0.0,0.0,"(3.999, 24.0]",Q1
36041,2020-03-14,4434,12,0,0,0,0,0.0,0.0,"(3.999, 24.0]",Q1
36041,2020-03-15,4434,12,0,0,0,0,0.0,0.0,"(3.999, 24.0]",Q1
36041,2020-03-16,4434,12,0,0,0,0,0.0,0.0,"(3.999, 24.0]",Q1
36041,2020-03-17,4434,12,1,1,2,2,0.14285714285714285,3.221857078420001,"(3.999, 24.0]",Q1
36041,2020-03-18,4434,12,1,2,8,10,0.2857142857142857,6.443714156840002,"(3.999, 24.0]",Q1
36041,2020-03-19,4434,12,0,2,0,10,0.2857142857142857,6.443714156840002,"(3.999, 24.0]",Q1
36041,2020-03-20,4434,12,0,2,1,11,0.2857142857142857,6.443714156840002,"(3.999, 24.0]",Q1
36041,2020-03-21,4434,12,0,2,0,11,0.2857142857142857,6.443714156840002,"(3.999, 24.0]",Q1
36041,2020-03-22,4434,12,0,2,0,11,0.2857142857142857,6.443714156840002,"(3.999, 24.0]",Q1
36041,2020-03-23,4434,12,0,2,2,13,0.2857142857142857,6.443714156840002,"(3.999, 24.0]",Q1
36041,2020-03-24,4434,12,0,2,1,14,0.14285714285714285,3.221857078420001,"(3.999, 24.0]",Q1
36041,2020-03-25,4434,12,0,2,0,14,0.0,0.0,"(3.999, 24.0]",Q1
36041,2020-03-26,4434,12,0,2,0,14,0.0,0.0,"(3.999, 24.0]",Q1
36041,2020-03-27,4434,12,0,2,0,14,0.0,0.0,"(3.999, 24.0]",Q1
36041,2020-03-28,4434,12,0,2,0,14,0.0,0.0,"(3.999, 24.0]",Q1
36041,2020-03-29,4434,12,0,2,0,14,0.0,0.0,"(3.999, 24.0]",Q1
36041,2020-03-30,4434,12,0,2,0,14,0.0,0.0,"(3.999, 24.0]",Q1
36041,2020-03-31,4434,12,0,2,0,14,0.0,0.0,"(3.999, 24.0]",Q1
36041,2020-04-01,4434,12,0,2,3,17,0.0,0.0,"(3.999, 24.0]",Q1
36041,2020-04-02,4434,12,0,2,0,17,0.0,0.0,"(3.999, 24.0]",Q1
36041,2020-04-03,4434,12,0,2,0,17,0.0,0.0,"(3.999, 24.0]",Q1
36041,2020-04-04,4434,12,0,2,0,17,0.0,0.0,"(3.999, 24.0]",Q1
36041,2020-04-05,4434,12,0,2,0,17,0.0,0.0,"(3.999, 24.0]",Q1
36041,2020-04-06,4434,12,0,2,0,17,0.0,0.0,"(3.999, 24.0]",Q1
36041,2020-04-07,4434,12,0,2,0,17,0.0,0.0,"(3.999, 24.0]",Q1
36041,2020-04-08,4434,12,1,3,1,18,0.14285714285714285,3.221857078420001,"(3.999, 24.0]",Q1
36041,2020-04-09,4434,12,0,3,0,18,0.14285714285714285,3.221857078420001,"(3.999, 24.0]",Q1
36041,2020-04-10,4434,12,0,3,1,19,0.14285714285714285,3.221857078420001,"(3.999, 24.0]",Q1
36041,2020-04-11,4434,12,0,3,0,19,0.14285714285714285,3.221857078420001,"(3.999, 24.0]",Q1
36041,2020-04-12,4434,12,0,3,1,20,0.14285714285714285,3.221857078420001,"(3.999, 24.0]",Q1
36041,2020-04-13,4434,12,0,3,0,20,0.14285714285714285,3.221857078420001,"(3.999, 24.0]",Q1
36041,2020-04-14,4434,12,0,3,0,20,0.14285714285714285,3.221857078420001,"(3.999, 24.0]",Q1
36041,2020-04-15,4434,12,0,3,0,20,0.0,0.0,"(3.999, 24.0]",Q1
36041,2020-04-16,4434,12,0,3,6,26,0.0,0.0,"(3.999, 24.0]",Q1
36041,2020-04-17,4434,12,0,3,1,27,0.0,0.0,"(3.999, 24.0]",Q1
36041,2020-04-18,4434,12,0,3,1,28,0.0,0.0,"(3.999, 24.0]",Q1
36041,2020-04-19,4434,12,0,3,0,28,0.0,0.0,"(3.999, 24.0]",Q1
36041,2020-04-20,4434,12,0,3,0,28,0.0,0.0,"(3.999, 24.0]",Q1
36041,2020-04-21,4434,12,0,3,1,29,0.0,0.0,"(3.999, 24.0]",Q1
36041,2020-04-22,4434,12,0,3,0,29,0.0,0.0,"(3.999, 24.0]",Q1
36041,2020-04-23,4434,12,0,3,0,29,0.0,0.0,"(3.999, 24.0]",Q1
36041,2020-04-24,4434,12,0,3,3,32,0.0,0.0,"(3.999, 24.0]",Q1
36041,2020-04-25,4434,12,0,3,1,33,0.0,0.0,"(3.999, 24.0]",Q1
36041,2020-04-26,4434,12,0,3,2,35,0.0,0.0,"(3.999, 24.0]",Q1
36041,2020-04-27,4434,12,0,3,1,36,0.0,0.0,"(3.999, 24.0]",Q1
36041,2020-04-28,4434,12,0,3,2,38,0.0,0.0,"(3.999, 24.0]",Q1
36041,2020-04-29,4434,12,0,3,0,38,0.0,0.0,"(3.999, 24.0]",Q1
36041,2020-04-30,4434,12,0,3,2,40,0.0,0.0,"(3.999, 24.0]",Q1
36041,2020-05-01,4434,12,0,3,3,43,0.0,0.0,"(3.999, 24.0]",Q1
36041,2020-05-02,4434,12,0,3,1,44,0.0,0.0,"(3.999, 24.0]",Q1
36041,2020-05-03,4434,12,0,3,2,46,0.0,0.0,"(3.999, 24.0]",Q1
36041,2020-05-04,4434,12,0,3,1,47,0.0,0.0,"(3.999, 24.0]",Q1
36041,2020-05-05,4434,12,2,5,6,53,0.2857142857142857,6.443714156840002,"(3.999, 24.0]",Q1
36041,2020-05-06,4434,12,0,5,0,53,0.2857142857142857,6.443714156840002,"(3.999, 24.0]",Q1
36041,2020-05-07,4434,12,0,5,4,57,0.2857142857142857,6.443714156840002,"(3.999, 24.0]",Q1
36041,2020-05-08,4434,12,0,5,3,60,0.2857142857142857,6.443714156840002,"(3.999, 24.0]",Q1
36041,2020-05-09,4434,12,0,5,1,61,0.2857142857142857,6.443714156840002,"(3.999, 24.0]",Q1
36041,2020-05-10,4434,12,0,5,0,61,0.2857142857142857,6.443714156840002,"(3.999, 24.0]",Q1
36041,2020-05-11,4434,12,0,5,0,61,0.2857142857142857,6.443714156840002,"(3.999, 24.0]",Q1
36041,2020-05-12,4434,12,0,5,6,67,0.0,0.0,"(3.999, 24.0]",Q1
36041,2020-05-13,4434,12,0,5,45,112,0.0,0.0,"(3.999, 24.0]",Q1
36041,2020-05-14,4434,12,0,5,10,122,0.0,0.0,"(3.999, 24.0]",Q1
36041,2020-05-15,4434,12,0,5,34,156,0.0,0.0,"(3.999, 24.0]",Q1
36041,2020-05-16,4434,12,0,5,139,295,0.0,0.0,"(3.999, 24.0]",Q1
36041,2020-05-17,4434,12,0,5,35,330,0.0,0.0,"(3.999, 24.0]",Q1
36041,2020-05-18,4434,12,0,5,2,332,0.0,0.0,"(3.999, 24.0]",Q1
36041,2020-05-19,4434,12,0,5,10,342,0.0,0.0,"(3.999, 24.0]",Q1
36041,2020-05-20,4434,12,0,5,12,354,0.0,0.0,"(3.999, 24.0]",Q1
36041,2020-05-21,4434,12,0,5,8,362,0.0,0.0,"(3.999, 24.0]",Q1
36041,2020-05-22,4434,12,0,5,38,400,0.0,0.0,"(3.999, 24.0]",Q1
36041,2020-05-23,4434,12,0,5,3,403,0.0,0.0,"(3.999, 24.0]",Q1
36041,2020-05-24,4434,12,0,5,3,406,0.0,0.0,"(3.999, 24.0]",Q1
36041,2020-05-25,4434,12,0,5,5,411,0.0,0.0,"(3.999, 24.0]",Q1
36041,2020-05-26,4434,12,0,5,1,412,0.0,0.0,"(3.999, 24.0]",Q1
36041,2020-05-27,4434,12,0,5,3,415,0.0,0.0,"(3.999, 24.0]",Q1
36041,2020-05-28,4434,12,0,5,4,419,0.0,0.0,"(3.999, 24.0]",Q1
36041,2020-05-29,4434,12,0,5,3,422,0.0,0.0,"(3.999, 24.0]",Q1
36041,2020-05-30,4434,12,0,5,22,444,0.0,0.0,"(3.999, 24.0]",Q1
36041,2020-05-31,4434,12,0,5,5,449,0.0,0.0,"(3.999, 24.0]",Q1
36041,2020-06-01,4434,12,0,5,1,450,0.0,0.0,"(3.999, 24.0]",Q1
36041,2020-06-02,4434,12,0,5,2,452,0.0,0.0,"(3.999, 24.0]",Q1
36041,2020-06-03,4434,12,0,5,74,526,0.0,0.0,"(3.999, 24.0]",Q1
36041,2020-06-04,4434,12,0,5,8,534,0.0,0.0,"(3.999, 24.0]",Q1
36041,2020-06-05,4434,12,0,5,7,541,0.0,0.0,"(3.999, 24.0]",Q1
36041,2020-06-06,4434,12,0,5,38,579,0.0,0.0,"(3.999, 24.0]",Q1
36041,2020-06-07,4434,12,0,5,8,587,0.0,0.0,"(3.999, 24.0]",Q1
36043,2020-03-02,61833,38,0,0,0,0,0.0,0.0,"(37.5, 52.0]",Q3
36043,2020-03-03,61833,38,0,0,0,0,0.0,0.0,"(37.5, 52.0]",Q3
36043,2020-03-04,61833,38,0,0,0,0,0.0,0.0,"(37.5, 52.0]",Q3
36043,2020-03-05,61833,38,0,0,0,0,0.0,0.0,"(37.5, 52.0]",Q3
36043,2020-03-06,61833,38,0,0,0,0,0.0,0.0,"(37.5, 52.0]",Q3
36043,2020-03-07,61833,38,0,0,0,0,0.0,0.0,"(37.5, 52.0]",Q3
36043,2020-03-08,61833,38,0,0,0,0,0.0,0.0,"(37.5, 52.0]",Q3
36043,2020-03-09,61833,38,0,0,0,0,0.0,0.0,"(37.5, 52.0]",Q3
36043,2020-03-10,61833,38,0,0,0,0,0.0,0.0,"(37.5, 52.0]",Q3
36043,2020-03-11,61833,38,0,0,0,0,0.0,0.0,"(37.5, 52.0]",Q3
36043,2020-03-12,61833,38,1,1,1,1,0.14285714285714285,0.23103705603341718,"(37.5, 52.0]",Q3
36043,2020-03-13,61833,38,0,1,0,1,0.14285714285714285,0.23103705603341718,"(37.5, 52.0]",Q3
36043,2020-03-14,61833,38,0,1,1,2,0.14285714285714285,0.23103705603341718,"(37.5, 52.0]",Q3
36043,2020-03-15,61833,38,0,1,0,2,0.14285714285714285,0.23103705603341718,"(37.5, 52.0]",Q3
36043,2020-03-16,61833,38,0,1,0,2,0.14285714285714285,0.23103705603341718,"(37.5, 52.0]",Q3
36043,2020-03-17,61833,38,0,1,0,2,0.14285714285714285,0.23103705603341718,"(37.5, 52.0]",Q3
36043,2020-03-18,61833,38,0,1,1,3,0.14285714285714285,0.23103705603341718,"(37.5, 52.0]",Q3
36043,2020-03-19,61833,38,1,2,1,4,0.14285714285714285,0.23103705603341718,"(37.5, 52.0]",Q3
36043,2020-03-20,61833,38,1,3,5,9,0.2857142857142857,0.46207411206683435,"(37.5, 52.0]",Q3
36043,2020-03-21,61833,38,1,4,10,19,0.42857142857142855,0.6931111681002515,"(37.5, 52.0]",Q3
36043,2020-03-22,61833,38,0,4,6,25,0.42857142857142855,0.6931111681002515,"(37.5, 52.0]",Q3
36043,2020-03-23,61833,38,0,4,3,28,0.42857142857142855,0.6931111681002515,"(37.5, 52.0]",Q3
36043,2020-03-24,61833,38,1,5,5,33,0.5714285714285714,0.9241482241336687,"(37.5, 52.0]",Q3
36043,2020-03-25,61833,38,2,7,6,39,0.8571428571428571,1.386222336200503,"(37.5, 52.0]",Q3
36043,2020-03-26,61833,38,2,9,9,48,1.0,1.6172593922339202,"(37.5, 52.0]",Q3
36043,2020-03-27,61833,38,0,9,8,56,0.8571428571428571,1.386222336200503,"(37.5, 52.0]",Q3
36043,2020-03-28,61833,38,1,10,14,70,0.8571428571428571,1.386222336200503,"(37.5, 52.0]",Q3
36043,2020-03-29,61833,38,2,12,8,78,1.1428571428571428,1.8482964482673374,"(37.5, 52.0]",Q3
36043,2020-03-30,61833,38,0,12,1,79,1.1428571428571428,1.8482964482673374,"(37.5, 52.0]",Q3
36043,2020-03-31,61833,38,0,12,4,83,1.0,1.6172593922339202,"(37.5, 52.0]",Q3
36043,2020-04-01,61833,38,2,14,9,92,1.0,1.6172593922339202,"(37.5, 52.0]",Q3
36043,2020-04-02,61833,38,0,14,19,111,0.7142857142857143,1.155185280167086,"(37.5, 52.0]",Q3
36043,2020-04-03,61833,38,4,18,27,138,1.2857142857142858,2.079333504300755,"(37.5, 52.0]",Q3
36043,2020-04-04,61833,38,4,22,46,184,1.7142857142857142,2.772444672401006,"(37.5, 52.0]",Q3
36043,2020-04-05,61833,38,3,25,23,207,1.8571428571428572,3.0034817284344237,"(37.5, 52.0]",Q3
36043,2020-04-06,61833,38,2,27,19,226,2.142857142857143,3.4655558405012576,"(37.5, 52.0]",Q3
36043,2020-04-07,61833,38,2,29,19,245,2.4285714285714284,3.927629952568092,"(37.5, 52.0]",Q3
36043,2020-04-08,61833,38,3,32,44,289,2.5714285714285716,4.15866700860151,"(37.5, 52.0]",Q3
36043,2020-04-09,61833,38,4,36,23,312,3.142857142857143,5.082815232735179,"(37.5, 52.0]",Q3
36043,2020-04-10,61833,38,1,37,12,324,2.7142857142857144,4.389704064634928,"(37.5, 52.0]",Q3
36043,2020-04-11,61833,38,0,37,11,335,2.142857142857143,3.4655558405012576,"(37.5, 52.0]",Q3
36043,2020-04-12,61833,38,1,38,29,364,1.8571428571428572,3.0034817284344237,"(37.5, 52.0]",Q3
36043,2020-04-13,61833,38,1,39,26,390,1.7142857142857142,2.772444672401006,"(37.5, 52.0]",Q3
36043,2020-04-14,61833,38,1,40,9,399,1.5714285714285714,2.5414076163675894,"(37.5, 52.0]",Q3
36043,2020-04-15,61833,38,3,43,23,422,1.5714285714285714,2.5414076163675894,"(37.5, 52.0]",Q3
36043,2020-04-16,61833,38,3,46,30,452,1.4285714285714286,2.310370560334172,"(37.5, 52.0]",Q3
36043,2020-04-17,61833,38,1,47,18,470,1.4285714285714286,2.310370560334172,"(37.5, 52.0]",Q3
36043,2020-04-18,61833,38,2,49,20,490,1.7142857142857142,2.772444672401006,"(37.5, 52.0]",Q3
36043,2020-04-19,61833,38,0,49,23,513,1.5714285714285714,2.5414076163675894,"(37.5, 52.0]",Q3
36043,2020-04-20,61833,38,1,50,7,520,1.5714285714285714,2.5414076163675894,"(37.5, 52.0]",Q3
36043,2020-04-21,61833,38,3,53,34,554,1.8571428571428572,3.0034817284344237,"(37.5, 52.0]",Q3
36043,2020-04-22,61833,38,1,54,25,579,1.5714285714285714,2.5414076163675894,"(37.5, 52.0]",Q3
36043,2020-04-23,61833,38,2,56,27,606,1.4285714285714286,2.310370560334172,"(37.5, 52.0]",Q3
36043,2020-04-24,61833,38,0,56,59,665,1.2857142857142858,2.079333504300755,"(37.5, 52.0]",Q3
36043,2020-04-25,61833,38,1,57,31,696,1.1428571428571428,1.8482964482673374,"(37.5, 52.0]",Q3
36043,2020-04-26,61833,38,1,58,26,722,1.2857142857142858,2.079333504300755,"(37.5, 52.0]",Q3
36043,2020-04-27,61833,38,0,58,14,736,1.1428571428571428,1.8482964482673374,"(37.5, 52.0]",Q3
36043,2020-04-28,61833,38,0,58,28,764,0.7142857142857143,1.155185280167086,"(37.5, 52.0]",Q3
36043,2020-04-29,61833,38,0,58,28,792,0.5714285714285714,0.9241482241336687,"(37.5, 52.0]",Q3
36043,2020-04-30,61833,38,2,60,28,820,0.5714285714285714,0.9241482241336687,"(37.5, 52.0]",Q3
36043,2020-05-01,61833,38,1,61,15,835,0.7142857142857143,1.155185280167086,"(37.5, 52.0]",Q3
36043,2020-05-02,61833,38,1,62,29,864,0.7142857142857143,1.155185280167086,"(37.5, 52.0]",Q3
36043,2020-05-03,61833,38,1,63,41,905,0.7142857142857143,1.155185280167086,"(37.5, 52.0]",Q3
36043,2020-05-04,61833,38,4,67,29,934,1.2857142857142858,2.079333504300755,"(37.5, 52.0]",Q3
36043,2020-05-05,61833,38,1,68,66,1000,1.4285714285714286,2.310370560334172,"(37.5, 52.0]",Q3
36043,2020-05-06,61833,38,6,74,65,1065,2.2857142857142856,3.696592896534675,"(37.5, 52.0]",Q3
36043,2020-05-07,61833,38,2,76,55,1120,2.2857142857142856,3.696592896534675,"(37.5, 52.0]",Q3
36043,2020-05-08,61833,38,1,77,43,1163,2.2857142857142856,3.696592896534675,"(37.5, 52.0]",Q3
36043,2020-05-09,61833,38,2,79,56,1219,2.4285714285714284,3.927629952568092,"(37.5, 52.0]",Q3
36043,2020-05-10,61833,38,2,81,57,1276,2.5714285714285716,4.15866700860151,"(37.5, 52.0]",Q3
36043,2020-05-11,61833,38,0,81,42,1318,2.0,3.2345187844678405,"(37.5, 52.0]",Q3
36043,2020-05-12,61833,38,3,84,61,1379,2.2857142857142856,3.696592896534675,"(37.5, 52.0]",Q3
36043,2020-05-13,61833,38,2,86,54,1433,1.7142857142857142,2.772444672401006,"(37.5, 52.0]",Q3
36043,2020-05-14,61833,38,1,87,49,1482,1.5714285714285714,2.5414076163675894,"(37.5, 52.0]",Q3
36043,2020-05-15,61833,38,4,91,50,1532,2.0,3.2345187844678405,"(37.5, 52.0]",Q3
36043,2020-05-16,61833,38,0,91,157,1689,1.7142857142857142,2.772444672401006,"(37.5, 52.0]",Q3
36043,2020-05-17,61833,38,1,92,68,1757,1.5714285714285714,2.5414076163675894,"(37.5, 52.0]",Q3
36043,2020-05-18,61833,38,0,92,65,1822,1.5714285714285714,2.5414076163675894,"(37.5, 52.0]",Q3
36043,2020-05-19,61833,38,1,93,95,1917,1.2857142857142858,2.079333504300755,"(37.5, 52.0]",Q3
36043,2020-05-20,61833,38,0,93,60,1977,1.0,1.6172593922339202,"(37.5, 52.0]",Q3
36043,2020-05-21,61833,38,2,95,77,2054,1.1428571428571428,1.8482964482673374,"(37.5, 52.0]",Q3
36043,2020-05-22,61833,38,5,100,212,2266,1.2857142857142858,2.079333504300755,"(37.5, 52.0]",Q3
36043,2020-05-23,61833,38,1,101,143,2409,1.4285714285714286,2.310370560334172,"(37.5, 52.0]",Q3
36043,2020-05-24,61833,38,2,103,237,2646,1.5714285714285714,2.5414076163675894,"(37.5, 52.0]",Q3
36043,2020-05-25,61833,38,0,103,45,2691,1.5714285714285714,2.5414076163675894,"(37.5, 52.0]",Q3
36043,2020-05-26,61833,38,2,105,328,3019,1.7142857142857142,2.772444672401006,"(37.5, 52.0]",Q3
36043,2020-05-27,61833,38,1,106,442,3461,1.8571428571428572,3.0034817284344237,"(37.5, 52.0]",Q3
36043,2020-05-28,61833,38,1,107,154,3615,1.7142857142857142,2.772444672401006,"(37.5, 52.0]",Q3
36043,2020-05-29,61833,38,0,107,332,3947,1.0,1.6172593922339202,"(37.5, 52.0]",Q3
36043,2020-05-30,61833,38,1,108,309,4256,1.0,1.6172593922339202,"(37.5, 52.0]",Q3
36043,2020-05-31,61833,38,1,109,131,4387,0.8571428571428571,1.386222336200503,"(37.5, 52.0]",Q3
36043,2020-06-01,61833,38,2,111,186,4573,1.1428571428571428,1.8482964482673374,"(37.5, 52.0]",Q3
36043,2020-06-02,61833,38,2,113,522,5095,1.1428571428571428,1.8482964482673374,"(37.5, 52.0]",Q3
36043,2020-06-03,61833,38,0,113,398,5493,1.0,1.6172593922339202,"(37.5, 52.0]",Q3
36043,2020-06-04,61833,38,2,115,334,5827,1.1428571428571428,1.8482964482673374,"(37.5, 52.0]",Q3
36043,2020-06-05,61833,38,7,122,523,6350,2.142857142857143,3.4655558405012576,"(37.5, 52.0]",Q3
36043,2020-06-06,61833,38,1,123,357,6707,2.142857142857143,3.4655558405012576,"(37.5, 52.0]",Q3
36043,2020-06-07,61833,38,1,124,377,7084,2.142857142857143,3.4655558405012576,"(37.5, 52.0]",Q3
36045,2020-03-02,111755,58,0,0,0,0,0.0,0.0,"(52.0, 100.0]",Q4
36045,2020-03-03,111755,58,0,0,0,0,0.0,0.0,"(52.0, 100.0]",Q4
36045,2020-03-04,111755,58,0,0,0,0,0.0,0.0,"(52.0, 100.0]",Q4
36045,2020-03-05,111755,58,0,0,0,0,0.0,0.0,"(52.0, 100.0]",Q4
36045,2020-03-06,111755,58,0,0,0,0,0.0,0.0,"(52.0, 100.0]",Q4
36045,2020-03-07,111755,58,0,0,1,1,0.0,0.0,"(52.0, 100.0]",Q4
36045,2020-03-08,111755,58,0,0,0,1,0.0,0.0,"(52.0, 100.0]",Q4
36045,2020-03-09,111755,58,0,0,0,1,0.0,0.0,"(52.0, 100.0]",Q4
36045,2020-03-10,111755,58,0,0,0,1,0.0,0.0,"(52.0, 100.0]",Q4
36045,2020-03-11,111755,58,0,0,1,2,0.0,0.0,"(52.0, 100.0]",Q4
36045,2020-03-12,111755,58,0,0,0,2,0.0,0.0,"(52.0, 100.0]",Q4
36045,2020-03-13,111755,58,0,0,0,2,0.0,0.0,"(52.0, 100.0]",Q4
36045,2020-03-14,111755,58,0,0,0,2,0.0,0.0,"(52.0, 100.0]",Q4
36045,2020-03-15,111755,58,0,0,1,3,0.0,0.0,"(52.0, 100.0]",Q4
36045,2020-03-16,111755,58,0,0,0,3,0.0,0.0,"(52.0, 100.0]",Q4
36045,2020-03-17,111755,58,0,0,2,5,0.0,0.0,"(52.0, 100.0]",Q4
36045,2020-03-18,111755,58,1,1,7,12,0.14285714285714285,0.12783064995493967,"(52.0, 100.0]",Q4
36045,2020-03-19,111755,58,0,1,13,25,0.14285714285714285,0.12783064995493967,"(52.0, 100.0]",Q4
36045,2020-03-20,111755,58,0,1,18,43,0.14285714285714285,0.12783064995493967,"(52.0, 100.0]",Q4
36045,2020-03-21,111755,58,0,1,4,47,0.14285714285714285,0.12783064995493967,"(52.0, 100.0]",Q4
36045,2020-03-22,111755,58,1,2,20,67,0.2857142857142857,0.25566129990987935,"(52.0, 100.0]",Q4
36045,2020-03-23,111755,58,0,2,1,68,0.2857142857142857,0.25566129990987935,"(52.0, 100.0]",Q4
36045,2020-03-24,111755,58,0,2,13,81,0.2857142857142857,0.25566129990987935,"(52.0, 100.0]",Q4
36045,2020-03-25,111755,58,1,3,31,112,0.2857142857142857,0.25566129990987935,"(52.0, 100.0]",Q4
36045,2020-03-26,111755,58,0,3,23,135,0.2857142857142857,0.25566129990987935,"(52.0, 100.0]",Q4
36045,2020-03-27,111755,58,3,6,45,180,0.7142857142857143,0.6391532497746985,"(52.0, 100.0]",Q4
36045,2020-03-28,111755,58,1,7,52,232,0.8571428571428571,0.7669838997296382,"(52.0, 100.0]",Q4
36045,2020-03-29,111755,58,4,11,100,332,1.2857142857142858,1.1504758495944574,"(52.0, 100.0]",Q4
36045,2020-03-30,111755,58,1,12,19,351,1.4285714285714286,1.278306499549397,"(52.0, 100.0]",Q4
36045,2020-03-31,111755,58,0,12,14,365,1.4285714285714286,1.278306499549397,"(52.0, 100.0]",Q4
36045,2020-04-01,111755,58,3,15,53,418,1.7142857142857142,1.5339677994592764,"(52.0, 100.0]",Q4
36045,2020-04-02,111755,58,3,18,56,474,2.142857142857143,1.9174597493240952,"(52.0, 100.0]",Q4
36045,2020-04-03,111755,58,2,20,38,512,2.0,1.789629099369156,"(52.0, 100.0]",Q4
36045,2020-04-04,111755,58,6,26,75,587,2.7142857142857144,2.4287823491438543,"(52.0, 100.0]",Q4
36045,2020-04-05,111755,58,7,33,98,685,3.142857142857143,2.8122742990086733,"(52.0, 100.0]",Q4
36045,2020-04-06,111755,58,6,39,63,748,3.857142857142857,3.451427548783372,"(52.0, 100.0]",Q4
36045,2020-04-07,111755,58,1,40,25,773,4.0,3.579258198738312,"(52.0, 100.0]",Q4
36045,2020-04-08,111755,58,2,42,84,857,3.857142857142857,3.451427548783372,"(52.0, 100.0]",Q4
36045,2020-04-09,111755,58,1,43,52,909,3.5714285714285716,3.1957662488734924,"(52.0, 100.0]",Q4
36045,2020-04-10,111755,58,1,44,43,952,3.4285714285714284,3.067935598918553,"(52.0, 100.0]",Q4
36045,2020-04-11,111755,58,2,46,47,999,2.857142857142857,2.556612999098794,"(52.0, 100.0]",Q4
36045,2020-04-12,111755,58,0,46,24,1023,1.8571428571428572,1.6617984494142162,"(52.0, 100.0]",Q4
36045,2020-04-13,111755,58,1,47,37,1060,1.1428571428571428,1.0226451996395174,"(52.0, 100.0]",Q4
36045,2020-04-14,111755,58,0,47,1,1061,1.0,0.894814549684578,"(52.0, 100.0]",Q4
36045,2020-04-15,111755,58,1,48,33,1094,0.8571428571428571,0.7669838997296382,"(52.0, 100.0]",Q4
36045,2020-04-16,111755,58,2,50,31,1125,1.0,0.894814549684578,"(52.0, 100.0]",Q4
36045,2020-04-17,111755,58,0,50,16,1141,0.8571428571428571,0.7669838997296382,"(52.0, 100.0]",Q4
36045,2020-04-18,111755,58,4,54,53,1194,1.1428571428571428,1.0226451996395174,"(52.0, 100.0]",Q4
36045,2020-04-19,111755,58,0,54,23,1217,1.1428571428571428,1.0226451996395174,"(52.0, 100.0]",Q4
36045,2020-04-20,111755,58,0,54,7,1224,1.0,0.894814549684578,"(52.0, 100.0]",Q4
36045,2020-04-21,111755,58,0,54,8,1232,1.0,0.894814549684578,"(52.0, 100.0]",Q4
36045,2020-04-22,111755,58,2,56,28,1260,1.1428571428571428,1.0226451996395174,"(52.0, 100.0]",Q4
36045,2020-04-23,111755,58,2,58,37,1297,1.1428571428571428,1.0226451996395174,"(52.0, 100.0]",Q4
36045,2020-04-24,111755,58,1,59,63,1360,1.2857142857142858,1.1504758495944574,"(52.0, 100.0]",Q4
36045,2020-04-25,111755,58,1,60,27,1387,0.8571428571428571,0.7669838997296382,"(52.0, 100.0]",Q4
36045,2020-04-26,111755,58,0,60,52,1439,0.8571428571428571,0.7669838997296382,"(52.0, 100.0]",Q4
36045,2020-04-27,111755,58,0,60,15,1454,0.8571428571428571,0.7669838997296382,"(52.0, 100.0]",Q4
36045,2020-04-28,111755,58,0,60,28,1482,0.8571428571428571,0.7669838997296382,"(52.0, 100.0]",Q4
36045,2020-04-29,111755,58,1,61,36,1518,0.7142857142857143,0.6391532497746985,"(52.0, 100.0]",Q4
36045,2020-04-30,111755,58,0,61,37,1555,0.42857142857142855,0.3834919498648191,"(52.0, 100.0]",Q4
36045,2020-05-01,111755,58,1,62,48,1603,0.42857142857142855,0.3834919498648191,"(52.0, 100.0]",Q4
36045,2020-05-02,111755,58,0,62,48,1651,0.2857142857142857,0.25566129990987935,"(52.0, 100.0]",Q4
36045,2020-05-03,111755,58,1,63,82,1733,0.42857142857142855,0.3834919498648191,"(52.0, 100.0]",Q4
36045,2020-05-04,111755,58,0,63,13,1746,0.42857142857142855,0.3834919498648191,"(52.0, 100.0]",Q4
36045,2020-05-05,111755,58,0,63,50,1796,0.42857142857142855,0.3834919498648191,"(52.0, 100.0]",Q4
36045,2020-05-06,111755,58,1,64,90,1886,0.42857142857142855,0.3834919498648191,"(52.0, 100.0]",Q4
36045,2020-05-07,111755,58,2,66,82,1968,0.7142857142857143,0.6391532497746985,"(52.0, 100.0]",Q4
36045,2020-05-08,111755,58,1,67,47,2015,0.7142857142857143,0.6391532497746985,"(52.0, 100.0]",Q4
36045,2020-05-09,111755,58,1,68,64,2079,0.8571428571428571,0.7669838997296382,"(52.0, 100.0]",Q4
36045,2020-05-10,111755,58,0,68,63,2142,0.7142857142857143,0.6391532497746985,"(52.0, 100.0]",Q4
36045,2020-05-11,111755,58,0,68,46,2188,0.7142857142857143,0.6391532497746985,"(52.0, 100.0]",Q4
36045,2020-05-12,111755,58,0,68,80,2268,0.7142857142857143,0.6391532497746985,"(52.0, 100.0]",Q4
36045,2020-05-13,111755,58,1,69,104,2372,0.7142857142857143,0.6391532497746985,"(52.0, 100.0]",Q4
36045,2020-05-14,111755,58,2,71,453,2825,0.7142857142857143,0.6391532497746985,"(52.0, 100.0]",Q4
36045,2020-05-15,111755,58,0,71,237,3062,0.5714285714285714,0.5113225998197587,"(52.0, 100.0]",Q4
36045,2020-05-16,111755,58,0,71,152,3214,0.42857142857142855,0.3834919498648191,"(52.0, 100.0]",Q4
36045,2020-05-17,111755,58,0,71,137,3351,0.42857142857142855,0.3834919498648191,"(52.0, 100.0]",Q4
36045,2020-05-18,111755,58,0,71,90,3441,0.42857142857142855,0.3834919498648191,"(52.0, 100.0]",Q4
36045,2020-05-19,111755,58,0,71,64,3505,0.42857142857142855,0.3834919498648191,"(52.0, 100.0]",Q4
36045,2020-05-20,111755,58,0,71,324,3829,0.2857142857142857,0.25566129990987935,"(52.0, 100.0]",Q4
36045,2020-05-21,111755,58,1,72,319,4148,0.14285714285714285,0.12783064995493967,"(52.0, 100.0]",Q4
36045,2020-05-22,111755,58,0,72,331,4479,0.14285714285714285,0.12783064995493967,"(52.0, 100.0]",Q4
36045,2020-05-23,111755,58,0,72,305,4784,0.14285714285714285,0.12783064995493967,"(52.0, 100.0]",Q4
36045,2020-05-24,111755,58,0,72,107,4891,0.14285714285714285,0.12783064995493967,"(52.0, 100.0]",Q4
36045,2020-05-25,111755,58,0,72,71,4962,0.14285714285714285,0.12783064995493967,"(52.0, 100.0]",Q4
36045,2020-05-26,111755,58,0,72,97,5059,0.14285714285714285,0.12783064995493967,"(52.0, 100.0]",Q4
36045,2020-05-27,111755,58,0,72,136,5195,0.14285714285714285,0.12783064995493967,"(52.0, 100.0]",Q4
36045,2020-05-28,111755,58,2,74,400,5595,0.2857142857142857,0.25566129990987935,"(52.0, 100.0]",Q4
36045,2020-05-29,111755,58,0,74,227,5822,0.2857142857142857,0.25566129990987935,"(52.0, 100.0]",Q4
36045,2020-05-30,111755,58,0,74,280,6102,0.2857142857142857,0.25566129990987935,"(52.0, 100.0]",Q4
36045,2020-05-31,111755,58,0,74,256,6358,0.2857142857142857,0.25566129990987935,"(52.0, 100.0]",Q4
36045,2020-06-01,111755,58,0,74,228,6586,0.2857142857142857,0.25566129990987935,"(52.0, 100.0]",Q4
36045,2020-06-02,111755,58,0,74,256,6842,0.2857142857142857,0.25566129990987935,"(52.0, 100.0]",Q4
36045,2020-06-03,111755,58,0,74,253,7095,0.2857142857142857,0.25566129990987935,"(52.0, 100.0]",Q4
36045,2020-06-04,111755,58,1,75,482,7577,0.14285714285714285,0.12783064995493967,"(52.0, 100.0]",Q4
36045,2020-06-05,111755,58,0,75,315,7892,0.14285714285714285,0.12783064995493967,"(52.0, 100.0]",Q4
36045,2020-06-06,111755,58,2,77,275,8167,0.42857142857142855,0.3834919498648191,"(52.0, 100.0]",Q4
36045,2020-06-07,111755,58,1,78,374,8541,0.5714285714285714,0.5113225998197587,"(52.0, 100.0]",Q4
36047,2020-03-02,2582830,99,0,0,0,0,0.0,0.0,"(52.0, 100.0]",Q4
36047,2020-03-03,2582830,99,0,0,2,2,0.0,0.0,"(52.0, 100.0]",Q4
36047,2020-03-04,2582830,99,1,1,4,6,1.0,0.03871722103274316,"(52.0, 100.0]",Q4
36047,2020-03-05,2582830,99,0,1,7,13,0.0,0.0,"(52.0, 100.0]",Q4
36047,2020-03-06,2582830,99,3,4,12,25,3.0,0.11615166309822945,"(52.0, 100.0]",Q4
36047,2020-03-07,2582830,99,0,4,9,34,0.0,0.0,"(52.0, 100.0]",Q4
36047,2020-03-08,2582830,99,2,6,10,44,0.8571428571428571,0.03318618945663698,"(52.0, 100.0]",Q4
36047,2020-03-09,2582830,99,1,7,31,75,1.0,0.03871722103274316,"(52.0, 100.0]",Q4
36047,2020-03-10,2582830,99,7,14,29,104,2.0,0.07743444206548632,"(52.0, 100.0]",Q4
36047,2020-03-11,2582830,99,2,16,24,128,2.142857142857143,0.08296547364159247,"(52.0, 100.0]",Q4
36047,2020-03-12,2582830,99,8,24,59,187,3.2857142857142856,0.12721372625044178,"(52.0, 100.0]",Q4
36047,2020-03-13,2582830,99,17,41,136,323,5.285714285714286,0.2046481683159281,"(52.0, 100.0]",Q4
36047,2020-03-14,2582830,99,17,58,99,422,7.714285714285714,0.2986757051097329,"(52.0, 100.0]",Q4
36047,2020-03-15,2582830,99,26,84,166,588,11.142857142857142,0.4314204629362809,"(52.0, 100.0]",Q4
36047,2020-03-16,2582830,99,39,123,171,759,16.571428571428573,0.6415996628283153,"(52.0, 100.0]",Q4
36047,2020-03-17,2582830,99,264,387,741,1500,53.285714285714285,2.0630747778875995,"(52.0, 100.0]",Q4
36047,2020-03-18,2582830,99,273,660,795,2295,92.0,3.56198433501237,"(52.0, 100.0]",Q4
36047,2020-03-19,2582830,99,674,1334,1553,3848,187.14285714285714,7.245651364699076,"(52.0, 100.0]",Q4
36047,2020-03-20,2582830,99,538,1872,1378,5226,261.57142857142856,10.127318815850387,"(52.0, 100.0]",Q4
36047,2020-03-21,2582830,99,893,2765,1941,7167,386.7142857142857,14.972502476519388,"(52.0, 100.0]",Q4
36047,2020-03-22,2582830,99,702,3467,1506,8673,483.2857142857143,18.711479821967156,"(52.0, 100.0]",Q4
36047,2020-03-23,2582830,99,700,4167,1422,10095,577.7142857142857,22.367491693773328,"(52.0, 100.0]",Q4
36047,2020-03-24,2582830,99,779,4946,1474,11569,651.2857142857143,25.215972955468008,"(52.0, 100.0]",Q4
36047,2020-03-25,2582830,99,755,5701,1550,13119,720.1428571428571,27.881930175151176,"(52.0, 100.0]",Q4
36047,2020-03-26,2582830,99,1106,6807,1905,15024,781.8571428571429,30.27133581602904,"(52.0, 100.0]",Q4
36047,2020-03-27,2582830,99,1238,8045,2254,17278,881.8571428571429,34.14305791930336,"(52.0, 100.0]",Q4
36047,2020-03-28,2582830,99,973,9018,1790,19068,893.2857142857143,34.58554044539185,"(52.0, 100.0]",Q4
36047,2020-03-29,2582830,99,1011,10029,1627,20695,937.4285714285714,36.29462920240866,"(52.0, 100.0]",Q4
36047,2020-03-30,2582830,99,1888,11917,3113,23808,1107.142857142857,42.86549471482278,"(52.0, 100.0]",Q4
36047,2020-03-31,2582830,99,1198,13115,2011,25819,1167.0,45.18299694521126,"(52.0, 100.0]",Q4
36047,2020-04-01,2582830,99,1189,14304,2041,27860,1229.0,47.583464649241336,"(52.0, 100.0]",Q4
36047,2020-04-02,2582830,99,1396,15700,2512,30372,1270.4285714285713,49.187463806312124,"(52.0, 100.0]",Q4
36047,2020-04-03,2582830,99,1804,17504,3234,33606,1351.2857142857142,52.31802767838821,"(52.0, 100.0]",Q4
36047,2020-04-04,2582830,99,1054,18558,1990,35596,1362.857142857143,52.76604123605281,"(52.0, 100.0]",Q4
36047,2020-04-05,2582830,99,1144,19702,2013,37609,1381.857142857143,53.50166843567494,"(52.0, 100.0]",Q4
36047,2020-04-06,2582830,99,1177,20879,2245,39854,1280.2857142857142,49.56910498506345,"(52.0, 100.0]",Q4
36047,2020-04-07,2582830,99,1203,22082,2607,42461,1281.0,49.596760142943985,"(52.0, 100.0]",Q4
36047,2020-04-08,2582830,99,1312,23394,2565,45026,1298.5714285714287,50.277077026805046,"(52.0, 100.0]",Q4
36047,2020-04-09,2582830,99,1321,24715,2578,47604,1287.857142857143,49.86224965859708,"(52.0, 100.0]",Q4
36047,2020-04-10,2582830,99,1528,26243,2887,50491,1248.4285714285713,48.33568494359177,"(52.0, 100.0]",Q4
36047,2020-04-11,2582830,99,1228,27471,2670,53161,1273.2857142857142,49.29808443783425,"(52.0, 100.0]",Q4
36047,2020-04-12,2582830,99,933,28404,2029,55190,1243.142857142857,48.131036775275845,"(52.0, 100.0]",Q4
36047,2020-04-13,2582830,99,902,29306,2055,57245,1203.857142857143,46.61000309184665,"(52.0, 100.0]",Q4
36047,2020-04-14,2582830,99,2663,31969,5103,62348,1412.4285714285713,54.685309192961654,"(52.0, 100.0]",Q4
36047,2020-04-15,2582830,99,1552,33521,3724,66072,1446.7142857142858,56.01275677122713,"(52.0, 100.0]",Q4
36047,2020-04-16,2582830,99,1184,34705,3347,69419,1427.142857142857,55.25500544530059,"(52.0, 100.0]",Q4
36047,2020-04-17,2582830,99,1058,35763,3016,72435,1360.0,52.6554206045307,"(52.0, 100.0]",Q4
36047,2020-04-18,2582830,99,719,36482,2390,74825,1287.2857142857142,49.84012553229265,"(52.0, 100.0]",Q4
36047,2020-04-19,2582830,99,548,37030,1835,76660,1232.2857142857142,47.710678375491774,"(52.0, 100.0]",Q4
36047,2020-04-20,2582830,99,664,37694,2300,78960,1198.2857142857142,46.394292860378506,"(52.0, 100.0]",Q4
36047,2020-04-21,2582830,99,787,38481,2827,81787,930.2857142857143,36.01807762360335,"(52.0, 100.0]",Q4
36047,2020-04-22,2582830,99,873,39354,3526,85313,833.2857142857143,32.26250718342726,"(52.0, 100.0]",Q4
36047,2020-04-23,2582830,99,1294,40648,5030,90343,849.0,32.87092065679894,"(52.0, 100.0]",Q4
36047,2020-04-24,2582830,99,1012,41660,4021,94364,842.4285714285714,32.61649320429805,"(52.0, 100.0]",Q4
36047,2020-04-25,2582830,99,827,42487,3685,98049,857.8571428571429,33.21384461451752,"(52.0, 100.0]",Q4
36047,2020-04-26,2582830,99,527,43014,2684,100733,854.8571428571429,33.09769295141929,"(52.0, 100.0]",Q4
36047,2020-04-27,2582830,99,573,43587,2940,103673,841.8571428571429,32.59436907799363,"(52.0, 100.0]",Q4
36047,2020-04-28,2582830,99,649,44236,3873,107546,822.1428571428571,31.831086720490976,"(52.0, 100.0]",Q4
36047,2020-04-29,2582830,99,636,44872,3944,111490,788.2857142857143,30.52023223695382,"(52.0, 100.0]",Q4
36047,2020-04-30,2582830,99,647,45519,3927,115417,695.8571428571429,26.941654807213133,"(52.0, 100.0]",Q4
36047,2020-05-01,2582830,99,756,46275,4717,120134,659.2857142857143,25.525710723729954,"(52.0, 100.0]",Q4
36047,2020-05-02,2582830,99,564,46839,3804,123938,621.7142857142857,24.071049419214027,"(52.0, 100.0]",Q4
36047,2020-05-03,2582830,99,344,47183,2545,126483,595.5714285714286,23.0588706407866,"(52.0, 100.0]",Q4
36047,2020-05-04,2582830,99,396,47579,3364,129847,570.2857142857143,22.079878051815815,"(52.0, 100.0]",Q4
36047,2020-05-05,2582830,99,395,47974,3597,133444,534.0,20.674996031484845,"(52.0, 100.0]",Q4
36047,2020-05-06,2582830,99,576,48550,5284,138728,525.4285714285714,20.343134136918476,"(52.0, 100.0]",Q4
36047,2020-05-07,2582830,99,448,48998,4582,143310,497.0,19.242458853273348,"(52.0, 100.0]",Q4
36047,2020-05-08,2582830,99,463,49461,4747,148057,455.14285714285717,17.62186660147424,"(52.0, 100.0]",Q4
36047,2020-05-09,2582830,99,356,49817,3682,151739,425.42857142857144,16.47141203364416,"(52.0, 100.0]",Q4
36047,2020-05-10,2582830,99,255,50072,2825,154564,412.7142857142857,15.97915022337071,"(52.0, 100.0]",Q4
36047,2020-05-11,2582830,99,259,50331,2984,157548,393.14285714285717,15.221398897444168,"(52.0, 100.0]",Q4
36047,2020-05-12,2582830,99,336,50667,4615,162163,384.7142857142857,14.895068034453903,"(52.0, 100.0]",Q4
36047,2020-05-13,2582830,99,428,51095,6107,168270,363.57142857142856,14.07647536119019,"(52.0, 100.0]",Q4
36047,2020-05-14,2582830,99,486,51581,5741,174011,369.0,14.286654561082225,"(52.0, 100.0]",Q4
36047,2020-05-15,2582830,99,410,51991,5793,179804,361.42857142857144,13.993509887548598,"(52.0, 100.0]",Q4
36047,2020-05-16,2582830,99,307,52298,4377,184181,354.42857142857144,13.722489340319395,"(52.0, 100.0]",Q4
36047,2020-05-17,2582830,99,187,52485,3052,187233,344.7142857142857,13.346379193144177,"(52.0, 100.0]",Q4
36047,2020-05-18,2582830,99,196,52681,4133,191366,335.7142857142857,12.99792420384949,"(52.0, 100.0]",Q4
36047,2020-05-19,2582830,99,208,52889,3890,195256,317.42857142857144,12.289952162107898,"(52.0, 100.0]",Q4
36047,2020-05-20,2582830,99,496,53385,7252,202508,327.14285714285717,12.66606230928312,"(52.0, 100.0]",Q4
36047,2020-05-21,2582830,99,254,53639,5372,207880,294.0,11.382862983626486,"(52.0, 100.0]",Q4
36047,2020-05-22,2582830,99,263,53902,6189,214069,273.0,10.56980134193888,"(52.0, 100.0]",Q4
36047,2020-05-23,2582830,99,273,54175,6813,220882,268.14285714285717,10.381746268351272,"(52.0, 100.0]",Q4
36047,2020-05-24,2582830,99,185,54360,4990,225872,267.85714285714283,10.370684205199058,"(52.0, 100.0]",Q4
36047,2020-05-25,2582830,99,200,54560,5214,231086,268.42857142857144,10.392808331503485,"(52.0, 100.0]",Q4
36047,2020-05-26,2582830,99,219,54779,5940,237026,270.0,10.453649678840652,"(52.0, 100.0]",Q4
36047,2020-05-27,2582830,99,368,55147,10938,247964,251.71428571428572,9.745677637099064,"(52.0, 100.0]",Q4
36047,2020-05-28,2582830,99,299,55446,10686,258650,258.14285714285717,9.99457405802384,"(52.0, 100.0]",Q4
36047,2020-05-29,2582830,99,281,55727,9619,268269,260.7142857142857,10.094132626393751,"(52.0, 100.0]",Q4
36047,2020-05-30,2582830,99,173,55900,7167,275436,246.42857142857142,9.541029468783135,"(52.0, 100.0]",Q4
36047,2020-05-31,2582830,99,153,56053,5765,281201,241.85714285714286,9.364036458347737,"(52.0, 100.0]",Q4
36047,2020-06-01,2582830,99,189,56242,7500,288701,240.28571428571428,9.303195111010568,"(52.0, 100.0]",Q4
36047,2020-06-02,2582830,99,163,56405,7485,296186,232.28571428571428,8.993457342748624,"(52.0, 100.0]",Q4
36047,2020-06-03,2582830,99,182,56587,7880,304066,205.71428571428572,7.964685469592878,"(52.0, 100.0]",Q4
36047,2020-06-04,2582830,99,183,56770,7659,311725,189.14285714285714,7.3230858067645626,"(52.0, 100.0]",Q4
36047,2020-06-05,2582830,99,196,56966,9370,321095,177.0,6.852948122795539,"(52.0, 100.0]",Q4
36047,2020-06-06,2582830,99,165,57131,8378,329473,175.85714285714286,6.808699870186689,"(52.0, 100.0]",Q4
36047,2020-06-07,2582830,99,129,57260,7254,336727,172.42857142857142,6.67595511236014,"(52.0, 100.0]",Q4
36049,2020-03-02,26447,19,0,0,0,0,0.0,0.0,"(3.999, 24.0]",Q1
36049,2020-03-03,26447,19,0,0,0,0,0.0,0.0,"(3.999, 24.0]",Q1
36049,2020-03-04,26447,19,0,0,0,0,0.0,0.0,"(3.999, 24.0]",Q1
36049,2020-03-05,26447,19,0,0,0,0,0.0,0.0,"(3.999, 24.0]",Q1
36049,2020-03-06,26447,19,0,0,0,0,0.0,0.0,"(3.999, 24.0]",Q1
36049,2020-03-07,26447,19,0,0,0,0,0.0,0.0,"(3.999, 24.0]",Q1
36049,2020-03-08,26447,19,0,0,0,0,0.0,0.0,"(3.999, 24.0]",Q1
36049,2020-03-09,26447,19,0,0,0,0,0.0,0.0,"(3.999, 24.0]",Q1
36049,2020-03-10,26447,19,0,0,0,0,0.0,0.0,"(3.999, 24.0]",Q1
36049,2020-03-11,26447,19,0,0,0,0,0.0,0.0,"(3.999, 24.0]",Q1
36049,2020-03-12,26447,19,0,0,0,0,0.0,0.0,"(3.999, 24.0]",Q1
36049,2020-03-13,26447,19,0,0,1,1,0.0,0.0,"(3.999, 24.0]",Q1
36049,2020-03-14,26447,19,0,0,0,1,0.0,0.0,"(3.999, 24.0]",Q1
36049,2020-03-15,26447,19,0,0,2,3,0.0,0.0,"(3.999, 24.0]",Q1
36049,2020-03-16,26447,19,0,0,0,3,0.0,0.0,"(3.999, 24.0]",Q1
36049,2020-03-17,26447,19,0,0,1,4,0.0,0.0,"(3.999, 24.0]",Q1
36049,2020-03-18,26447,19,0,0,0,4,0.0,0.0,"(3.999, 24.0]",Q1
36049,2020-03-19,26447,19,0,0,2,6,0.0,0.0,"(3.999, 24.0]",Q1
36049,2020-03-20,26447,19,0,0,1,7,0.0,0.0,"(3.999, 24.0]",Q1
36049,2020-03-21,26447,19,0,0,4,11,0.0,0.0,"(3.999, 24.0]",Q1
36049,2020-03-22,26447,19,0,0,4,15,0.0,0.0,"(3.999, 24.0]",Q1
36049,2020-03-23,26447,19,0,0,5,20,0.0,0.0,"(3.999, 24.0]",Q1
36049,2020-03-24,26447,19,0,0,0,20,0.0,0.0,"(3.999, 24.0]",Q1
36049,2020-03-25,26447,19,0,0,5,25,0.0,0.0,"(3.999, 24.0]",Q1
36049,2020-03-26,26447,19,0,0,5,30,0.0,0.0,"(3.999, 24.0]",Q1
36049,2020-03-27,26447,19,0,0,6,36,0.0,0.0,"(3.999, 24.0]",Q1
36049,2020-03-28,26447,19,2,2,7,43,0.2857142857142857,1.0803277714458566,"(3.999, 24.0]",Q1
36049,2020-03-29,26447,19,0,2,16,59,0.2857142857142857,1.0803277714458566,"(3.999, 24.0]",Q1
36049,2020-03-30,26447,19,0,2,5,64,0.2857142857142857,1.0803277714458566,"(3.999, 24.0]",Q1
36049,2020-03-31,26447,19,0,2,3,67,0.2857142857142857,1.0803277714458566,"(3.999, 24.0]",Q1
36049,2020-04-01,26447,19,0,2,5,72,0.2857142857142857,1.0803277714458566,"(3.999, 24.0]",Q1
36049,2020-04-02,26447,19,0,2,5,77,0.2857142857142857,1.0803277714458566,"(3.999, 24.0]",Q1
36049,2020-04-03,26447,19,0,2,5,82,0.2857142857142857,1.0803277714458566,"(3.999, 24.0]",Q1
36049,2020-04-04,26447,19,1,3,19,101,0.14285714285714285,0.5401638857229283,"(3.999, 24.0]",Q1
36049,2020-04-05,26447,19,3,6,11,112,0.5714285714285714,2.160655542891713,"(3.999, 24.0]",Q1
36049,2020-04-06,26447,19,0,6,11,123,0.5714285714285714,2.160655542891713,"(3.999, 24.0]",Q1
36049,2020-04-07,26447,19,0,6,6,129,0.5714285714285714,2.160655542891713,"(3.999, 24.0]",Q1
36049,2020-04-08,26447,19,0,6,8,137,0.5714285714285714,2.160655542891713,"(3.999, 24.0]",Q1
36049,2020-04-09,26447,19,0,6,23,160,0.5714285714285714,2.160655542891713,"(3.999, 24.0]",Q1
36049,2020-04-10,26447,19,0,6,0,160,0.5714285714285714,2.160655542891713,"(3.999, 24.0]",Q1
36049,2020-04-11,26447,19,0,6,6,166,0.42857142857142855,1.620491657168785,"(3.999, 24.0]",Q1
36049,2020-04-12,26447,19,0,6,3,169,0.0,0.0,"(3.999, 24.0]",Q1
36049,2020-04-13,26447,19,1,7,11,180,0.14285714285714285,0.5401638857229283,"(3.999, 24.0]",Q1
36049,2020-04-14,26447,19,0,7,0,180,0.14285714285714285,0.5401638857229283,"(3.999, 24.0]",Q1
36049,2020-04-15,26447,19,1,8,7,187,0.2857142857142857,1.0803277714458566,"(3.999, 24.0]",Q1
36049,2020-04-16,26447,19,0,8,2,189,0.2857142857142857,1.0803277714458566,"(3.999, 24.0]",Q1
36049,2020-04-17,26447,19,0,8,0,189,0.2857142857142857,1.0803277714458566,"(3.999, 24.0]",Q1
36049,2020-04-18,26447,19,0,8,14,203,0.2857142857142857,1.0803277714458566,"(3.999, 24.0]",Q1
36049,2020-04-19,26447,19,1,9,7,210,0.42857142857142855,1.620491657168785,"(3.999, 24.0]",Q1
36049,2020-04-20,26447,19,0,9,1,211,0.2857142857142857,1.0803277714458566,"(3.999, 24.0]",Q1
36049,2020-04-21,26447,19,0,9,1,212,0.2857142857142857,1.0803277714458566,"(3.999, 24.0]",Q1
36049,2020-04-22,26447,19,0,9,8,220,0.14285714285714285,0.5401638857229283,"(3.999, 24.0]",Q1
36049,2020-04-23,26447,19,0,9,3,223,0.14285714285714285,0.5401638857229283,"(3.999, 24.0]",Q1
36049,2020-04-24,26447,19,0,9,41,264,0.14285714285714285,0.5401638857229283,"(3.999, 24.0]",Q1
36049,2020-04-25,26447,19,0,9,12,276,0.14285714285714285,0.5401638857229283,"(3.999, 24.0]",Q1
36049,2020-04-26,26447,19,0,9,14,290,0.0,0.0,"(3.999, 24.0]",Q1
36049,2020-04-27,26447,19,0,9,6,296,0.0,0.0,"(3.999, 24.0]",Q1
36049,2020-04-28,26447,19,0,9,4,300,0.0,0.0,"(3.999, 24.0]",Q1
36049,2020-04-29,26447,19,0,9,14,314,0.0,0.0,"(3.999, 24.0]",Q1
36049,2020-04-30,26447,19,0,9,4,318,0.0,0.0,"(3.999, 24.0]",Q1
36049,2020-05-01,26447,19,0,9,12,330,0.0,0.0,"(3.999, 24.0]",Q1
36049,2020-05-02,26447,19,0,9,1,331,0.0,0.0,"(3.999, 24.0]",Q1
36049,2020-05-03,26447,19,0,9,9,340,0.0,0.0,"(3.999, 24.0]",Q1
36049,2020-05-04,26447,19,0,9,6,346,0.0,0.0,"(3.999, 24.0]",Q1
36049,2020-05-05,26447,19,0,9,4,350,0.0,0.0,"(3.999, 24.0]",Q1
36049,2020-05-06,26447,19,1,10,25,375,0.14285714285714285,0.5401638857229283,"(3.999, 24.0]",Q1
36049,2020-05-07,26447,19,0,10,20,395,0.14285714285714285,0.5401638857229283,"(3.999, 24.0]",Q1
36049,2020-05-08,26447,19,1,11,85,480,0.2857142857142857,1.0803277714458566,"(3.999, 24.0]",Q1
36049,2020-05-09,26447,19,0,11,95,575,0.2857142857142857,1.0803277714458566,"(3.999, 24.0]",Q1
36049,2020-05-10,26447,19,0,11,65,640,0.2857142857142857,1.0803277714458566,"(3.999, 24.0]",Q1
36049,2020-05-11,26447,19,0,11,16,656,0.2857142857142857,1.0803277714458566,"(3.999, 24.0]",Q1
36049,2020-05-12,26447,19,0,11,10,666,0.2857142857142857,1.0803277714458566,"(3.999, 24.0]",Q1
36049,2020-05-13,26447,19,1,12,31,697,0.2857142857142857,1.0803277714458566,"(3.999, 24.0]",Q1
36049,2020-05-14,26447,19,0,12,236,933,0.2857142857142857,1.0803277714458566,"(3.999, 24.0]",Q1
36049,2020-05-15,26447,19,1,13,108,1041,0.2857142857142857,1.0803277714458566,"(3.999, 24.0]",Q1
36049,2020-05-16,26447,19,3,16,62,1103,0.7142857142857143,2.700819428614642,"(3.999, 24.0]",Q1
36049,2020-05-17,26447,19,1,17,123,1226,0.8571428571428571,3.24098331433757,"(3.999, 24.0]",Q1
36049,2020-05-18,26447,19,1,18,27,1253,1.0,3.781147200060498,"(3.999, 24.0]",Q1
36049,2020-05-19,26447,19,0,18,34,1287,1.0,3.781147200060498,"(3.999, 24.0]",Q1
36049,2020-05-20,26447,19,0,18,176,1463,0.8571428571428571,3.24098331433757,"(3.999, 24.0]",Q1
36049,2020-05-21,26447,19,1,19,101,1564,1.0,3.781147200060498,"(3.999, 24.0]",Q1
36049,2020-05-22,26447,19,0,19,62,1626,0.8571428571428571,3.24098331433757,"(3.999, 24.0]",Q1
36049,2020-05-23,26447,19,0,19,77,1703,0.42857142857142855,1.620491657168785,"(3.999, 24.0]",Q1
36049,2020-05-24,26447,19,0,19,43,1746,0.2857142857142857,1.0803277714458566,"(3.999, 24.0]",Q1
36049,2020-05-25,26447,19,1,20,25,1771,0.2857142857142857,1.0803277714458566,"(3.999, 24.0]",Q1
36049,2020-05-26,26447,19,0,20,22,1793,0.2857142857142857,1.0803277714458566,"(3.999, 24.0]",Q1
36049,2020-05-27,26447,19,0,20,34,1827,0.2857142857142857,1.0803277714458566,"(3.999, 24.0]",Q1
36049,2020-05-28,26447,19,0,20,148,1975,0.14285714285714285,0.5401638857229283,"(3.999, 24.0]",Q1
36049,2020-05-29,26447,19,0,20,77,2052,0.14285714285714285,0.5401638857229283,"(3.999, 24.0]",Q1
36049,2020-05-30,26447,19,0,20,51,2103,0.14285714285714285,0.5401638857229283,"(3.999, 24.0]",Q1
36049,2020-05-31,26447,19,0,20,64,2167,0.14285714285714285,0.5401638857229283,"(3.999, 24.0]",Q1
36049,2020-06-01,26447,19,0,20,70,2237,0.0,0.0,"(3.999, 24.0]",Q1
36049,2020-06-02,26447,19,0,20,93,2330,0.0,0.0,"(3.999, 24.0]",Q1
36049,2020-06-03,26447,19,0,20,72,2402,0.0,0.0,"(3.999, 24.0]",Q1
36049,2020-06-04,26447,19,0,20,178,2580,0.0,0.0,"(3.999, 24.0]",Q1
36049,2020-06-05,26447,19,0,20,109,2689,0.0,0.0,"(3.999, 24.0]",Q1
36049,2020-06-06,26447,19,0,20,59,2748,0.0,0.0,"(3.999, 24.0]",Q1
36049,2020-06-07,26447,19,0,20,115,2863,0.0,0.0,"(3.999, 24.0]",Q1
36051,2020-03-02,63227,28,0,0,0,0,0.0,0.0,"(24.0, 37.5]",Q2
36051,2020-03-03,63227,28,0,0,0,0,0.0,0.0,"(24.0, 37.5]",Q2
36051,2020-03-04,63227,28,0,0,0,0,0.0,0.0,"(24.0, 37.5]",Q2
36051,2020-03-05,63227,28,0,0,0,0,0.0,0.0,"(24.0, 37.5]",Q2
36051,2020-03-06,63227,28,0,0,0,0,0.0,0.0,"(24.0, 37.5]",Q2
36051,2020-03-07,63227,28,0,0,0,0,0.0,0.0,"(24.0, 37.5]",Q2
36051,2020-03-08,63227,28,0,0,0,0,0.0,0.0,"(24.0, 37.5]",Q2
36051,2020-03-09,63227,28,0,0,0,0,0.0,0.0,"(24.0, 37.5]",Q2
36051,2020-03-10,63227,28,0,0,1,1,0.0,0.0,"(24.0, 37.5]",Q2
36051,2020-03-11,63227,28,0,0,0,1,0.0,0.0,"(24.0, 37.5]",Q2
36051,2020-03-12,63227,28,0,0,0,1,0.0,0.0,"(24.0, 37.5]",Q2
36051,2020-03-13,63227,28,0,0,0,1,0.0,0.0,"(24.0, 37.5]",Q2
36051,2020-03-14,63227,28,0,0,0,1,0.0,0.0,"(24.0, 37.5]",Q2
36051,2020-03-15,63227,28,0,0,0,1,0.0,0.0,"(24.0, 37.5]",Q2
36051,2020-03-16,63227,28,0,0,0,1,0.0,0.0,"(24.0, 37.5]",Q2
36051,2020-03-17,63227,28,0,0,4,5,0.0,0.0,"(24.0, 37.5]",Q2
36051,2020-03-18,63227,28,0,0,5,10,0.0,0.0,"(24.0, 37.5]",Q2
36051,2020-03-19,63227,28,1,1,11,21,0.14285714285714285,0.22594325661053483,"(24.0, 37.5]",Q2
36051,2020-03-20,63227,28,1,2,13,34,0.2857142857142857,0.45188651322106965,"(24.0, 37.5]",Q2
36051,2020-03-21,63227,28,0,2,5,39,0.2857142857142857,0.45188651322106965,"(24.0, 37.5]",Q2
36051,2020-03-22,63227,28,1,3,3,42,0.42857142857142855,0.6778297698316045,"(24.0, 37.5]",Q2
36051,2020-03-23,63227,28,0,3,1,43,0.42857142857142855,0.6778297698316045,"(24.0, 37.5]",Q2
36051,2020-03-24,63227,28,0,3,9,52,0.42857142857142855,0.6778297698316045,"(24.0, 37.5]",Q2
36051,2020-03-25,63227,28,0,3,15,67,0.42857142857142855,0.6778297698316045,"(24.0, 37.5]",Q2
36051,2020-03-26,63227,28,0,3,8,75,0.2857142857142857,0.45188651322106965,"(24.0, 37.5]",Q2
36051,2020-03-27,63227,28,2,5,11,86,0.42857142857142855,0.6778297698316045,"(24.0, 37.5]",Q2
36051,2020-03-28,63227,28,5,10,17,103,1.1428571428571428,1.8075460528842786,"(24.0, 37.5]",Q2
36051,2020-03-29,63227,28,2,12,10,113,1.2857142857142858,2.0334893094948137,"(24.0, 37.5]",Q2
36051,2020-03-30,63227,28,1,13,10,123,1.4285714285714286,2.2594325661053483,"(24.0, 37.5]",Q2
36051,2020-03-31,63227,28,1,14,24,147,1.5714285714285714,2.4853758227158833,"(24.0, 37.5]",Q2
36051,2020-04-01,63227,28,0,14,17,164,1.5714285714285714,2.4853758227158833,"(24.0, 37.5]",Q2
36051,2020-04-02,63227,28,2,16,12,176,1.8571428571428572,2.937262335936953,"(24.0, 37.5]",Q2
36051,2020-04-03,63227,28,2,18,18,194,1.8571428571428572,2.937262335936953,"(24.0, 37.5]",Q2
36051,2020-04-04,63227,28,1,19,27,221,1.2857142857142858,2.0334893094948137,"(24.0, 37.5]",Q2
36051,2020-04-05,63227,28,3,22,14,235,1.4285714285714286,2.2594325661053483,"(24.0, 37.5]",Q2
36051,2020-04-06,63227,28,1,23,18,253,1.4285714285714286,2.2594325661053483,"(24.0, 37.5]",Q2
36051,2020-04-07,63227,28,2,25,23,276,1.5714285714285714,2.4853758227158833,"(24.0, 37.5]",Q2
36051,2020-04-08,63227,28,1,26,17,293,1.7142857142857142,2.711319079326418,"(24.0, 37.5]",Q2
36051,2020-04-09,63227,28,3,29,26,319,1.8571428571428572,2.937262335936953,"(24.0, 37.5]",Q2
36051,2020-04-10,63227,28,1,30,7,326,1.7142857142857142,2.711319079326418,"(24.0, 37.5]",Q2
36051,2020-04-11,63227,28,0,30,6,332,1.5714285714285714,2.4853758227158833,"(24.0, 37.5]",Q2
36051,2020-04-12,63227,28,0,30,5,337,1.1428571428571428,1.8075460528842786,"(24.0, 37.5]",Q2
36051,2020-04-13,63227,28,1,31,20,357,1.1428571428571428,1.8075460528842786,"(24.0, 37.5]",Q2
36051,2020-04-14,63227,28,0,31,8,365,0.8571428571428571,1.355659539663209,"(24.0, 37.5]",Q2
36051,2020-04-15,63227,28,1,32,8,373,0.8571428571428571,1.355659539663209,"(24.0, 37.5]",Q2
36051,2020-04-16,63227,28,2,34,18,391,0.7142857142857143,1.1297162830526741,"(24.0, 37.5]",Q2
36051,2020-04-17,63227,28,3,37,20,411,1.0,1.5816027962737438,"(24.0, 37.5]",Q2
36051,2020-04-18,63227,28,2,39,30,441,1.2857142857142858,2.0334893094948137,"(24.0, 37.5]",Q2
36051,2020-04-19,63227,28,0,39,7,448,1.2857142857142858,2.0334893094948137,"(24.0, 37.5]",Q2
36051,2020-04-20,63227,28,0,39,21,469,1.1428571428571428,1.8075460528842786,"(24.0, 37.5]",Q2
36051,2020-04-21,63227,28,0,39,15,484,1.1428571428571428,1.8075460528842786,"(24.0, 37.5]",Q2
36051,2020-04-22,63227,28,2,41,22,506,1.2857142857142858,2.0334893094948137,"(24.0, 37.5]",Q2
36051,2020-04-23,63227,28,3,44,54,560,1.4285714285714286,2.2594325661053483,"(24.0, 37.5]",Q2
36051,2020-04-24,63227,28,14,58,295,855,3.0,4.744808388821231,"(24.0, 37.5]",Q2
36051,2020-04-25,63227,28,2,60,61,916,3.0,4.744808388821231,"(24.0, 37.5]",Q2
36051,2020-04-26,63227,28,2,62,15,931,3.2857142857142856,5.1966949020423,"(24.0, 37.5]",Q2
36051,2020-04-27,63227,28,3,65,24,955,3.7142857142857144,5.874524671873906,"(24.0, 37.5]",Q2
36051,2020-04-28,63227,28,2,67,36,991,4.0,6.326411185094975,"(24.0, 37.5]",Q2
36051,2020-04-29,63227,28,2,69,34,1025,4.0,6.326411185094975,"(24.0, 37.5]",Q2
36051,2020-04-30,63227,28,4,73,43,1068,4.142857142857143,6.55235444170551,"(24.0, 37.5]",Q2
36051,2020-05-01,63227,28,3,76,44,1112,2.5714285714285716,4.066978618989627,"(24.0, 37.5]",Q2
36051,2020-05-02,63227,28,7,83,52,1164,3.2857142857142856,5.1966949020423,"(24.0, 37.5]",Q2
36051,2020-05-03,63227,28,2,85,26,1190,3.2857142857142856,5.1966949020423,"(24.0, 37.5]",Q2
36051,2020-05-04,63227,28,1,86,52,1242,3.0,4.744808388821231,"(24.0, 37.5]",Q2
36051,2020-05-05,63227,28,3,89,52,1294,3.142857142857143,4.970751645431767,"(24.0, 37.5]",Q2
36051,2020-05-06,63227,28,6,95,100,1394,3.7142857142857144,5.874524671873906,"(24.0, 37.5]",Q2
36051,2020-05-07,63227,28,5,100,56,1450,3.857142857142857,6.1004679284844405,"(24.0, 37.5]",Q2
36051,2020-05-08,63227,28,1,101,49,1499,3.5714285714285716,5.648581415263371,"(24.0, 37.5]",Q2
36051,2020-05-09,63227,28,1,102,58,1557,2.7142857142857144,4.292921875600162,"(24.0, 37.5]",Q2
36051,2020-05-10,63227,28,0,102,46,1603,2.4285714285714284,3.8410353623790923,"(24.0, 37.5]",Q2
36051,2020-05-11,63227,28,0,102,180,1783,2.2857142857142856,3.615092105768557,"(24.0, 37.5]",Q2
36051,2020-05-12,63227,28,1,103,197,1980,2.0,3.1632055925474876,"(24.0, 37.5]",Q2
36051,2020-05-13,63227,28,3,106,113,2093,1.5714285714285714,2.4853758227158833,"(24.0, 37.5]",Q2
36051,2020-05-14,63227,28,0,106,76,2169,0.8571428571428571,1.355659539663209,"(24.0, 37.5]",Q2
36051,2020-05-15,63227,28,1,107,75,2244,0.8571428571428571,1.355659539663209,"(24.0, 37.5]",Q2
36051,2020-05-16,63227,28,3,110,77,2321,1.1428571428571428,1.8075460528842786,"(24.0, 37.5]",Q2
36051,2020-05-17,63227,28,0,110,50,2371,1.1428571428571428,1.8075460528842786,"(24.0, 37.5]",Q2
36051,2020-05-18,63227,28,1,111,67,2438,1.2857142857142858,2.0334893094948137,"(24.0, 37.5]",Q2
36051,2020-05-19,63227,28,0,111,95,2533,1.1428571428571428,1.8075460528842786,"(24.0, 37.5]",Q2
36051,2020-05-20,63227,28,3,114,105,2638,1.1428571428571428,1.8075460528842786,"(24.0, 37.5]",Q2
36051,2020-05-21,63227,28,0,114,75,2713,1.1428571428571428,1.8075460528842786,"(24.0, 37.5]",Q2
36051,2020-05-22,63227,28,0,114,84,2797,1.0,1.5816027962737438,"(24.0, 37.5]",Q2
36051,2020-05-23,63227,28,0,114,65,2862,0.5714285714285714,0.9037730264421393,"(24.0, 37.5]",Q2
36051,2020-05-24,63227,28,1,115,196,3058,0.7142857142857143,1.1297162830526741,"(24.0, 37.5]",Q2
36051,2020-05-25,63227,28,3,118,74,3132,1.0,1.5816027962737438,"(24.0, 37.5]",Q2
36051,2020-05-26,63227,28,0,118,69,3201,1.0,1.5816027962737438,"(24.0, 37.5]",Q2
36051,2020-05-27,63227,28,0,118,129,3330,0.5714285714285714,0.9037730264421393,"(24.0, 37.5]",Q2
36051,2020-05-28,63227,28,0,118,122,3452,0.5714285714285714,0.9037730264421393,"(24.0, 37.5]",Q2
36051,2020-05-29,63227,28,0,118,107,3559,0.5714285714285714,0.9037730264421393,"(24.0, 37.5]",Q2
36051,2020-05-30,63227,28,1,119,128,3687,0.7142857142857143,1.1297162830526741,"(24.0, 37.5]",Q2
36051,2020-05-31,63227,28,0,119,136,3823,0.5714285714285714,0.9037730264421393,"(24.0, 37.5]",Q2
36051,2020-06-01,63227,28,0,119,218,4041,0.14285714285714285,0.22594325661053483,"(24.0, 37.5]",Q2
36051,2020-06-02,63227,28,1,120,233,4274,0.2857142857142857,0.45188651322106965,"(24.0, 37.5]",Q2
36051,2020-06-03,63227,28,0,120,172,4446,0.2857142857142857,0.45188651322106965,"(24.0, 37.5]",Q2
36051,2020-06-04,63227,28,1,121,263,4709,0.42857142857142855,0.6778297698316045,"(24.0, 37.5]",Q2
36051,2020-06-05,63227,28,0,121,167,4876,0.42857142857142855,0.6778297698316045,"(24.0, 37.5]",Q2
36051,2020-06-06,63227,28,0,121,133,5009,0.2857142857142857,0.45188651322106965,"(24.0, 37.5]",Q2
36051,2020-06-07,63227,28,0,121,177,5186,0.2857142857142857,0.45188651322106965,"(24.0, 37.5]",Q2
36053,2020-03-02,70795,14,0,0,0,0,0.0,0.0,"(3.999, 24.0]",Q1
36053,2020-03-03,70795,14,0,0,0,0,0.0,0.0,"(3.999, 24.0]",Q1
36053,2020-03-04,70795,14,0,0,0,0,0.0,0.0,"(3.999, 24.0]",Q1
36053,2020-03-05,70795,14,0,0,0,0,0.0,0.0,"(3.999, 24.0]",Q1
36053,2020-03-06,70795,14,0,0,0,0,0.0,0.0,"(3.999, 24.0]",Q1
36053,2020-03-07,70795,14,0,0,0,0,0.0,0.0,"(3.999, 24.0]",Q1
36053,2020-03-08,70795,14,0,0,0,0,0.0,0.0,"(3.999, 24.0]",Q1
36053,2020-03-09,70795,14,0,0,0,0,0.0,0.0,"(3.999, 24.0]",Q1
36053,2020-03-10,70795,14,0,0,0,0,0.0,0.0,"(3.999, 24.0]",Q1
36053,2020-03-11,70795,14,0,0,0,0,0.0,0.0,"(3.999, 24.0]",Q1
36053,2020-03-12,70795,14,0,0,0,0,0.0,0.0,"(3.999, 24.0]",Q1
36053,2020-03-13,70795,14,0,0,1,1,0.0,0.0,"(3.999, 24.0]",Q1
36053,2020-03-14,70795,14,0,0,1,2,0.0,0.0,"(3.999, 24.0]",Q1
36053,2020-03-15,70795,14,0,0,1,3,0.0,0.0,"(3.999, 24.0]",Q1
36053,2020-03-16,70795,14,0,0,1,4,0.0,0.0,"(3.999, 24.0]",Q1
36053,2020-03-17,70795,14,0,0,0,4,0.0,0.0,"(3.999, 24.0]",Q1
36053,2020-03-18,70795,14,0,0,7,11,0.0,0.0,"(3.999, 24.0]",Q1
36053,2020-03-19,70795,14,0,0,4,15,0.0,0.0,"(3.999, 24.0]",Q1
36053,2020-03-20,70795,14,0,0,9,24,0.0,0.0,"(3.999, 24.0]",Q1
36053,2020-03-21,70795,14,1,1,9,33,0.14285714285714285,0.2017898762019109,"(3.999, 24.0]",Q1
36053,2020-03-22,70795,14,3,4,14,47,0.5714285714285714,0.8071595048076436,"(3.999, 24.0]",Q1
36053,2020-03-23,70795,14,1,5,10,57,0.7142857142857143,1.0089493810095547,"(3.999, 24.0]",Q1
36053,2020-03-24,70795,14,2,7,15,72,1.0,1.4125291334133767,"(3.999, 24.0]",Q1
36053,2020-03-25,70795,14,2,9,28,100,1.2857142857142858,1.8161088858171988,"(3.999, 24.0]",Q1
36053,2020-03-26,70795,14,8,17,23,123,2.4285714285714284,3.430427895432486,"(3.999, 24.0]",Q1
36053,2020-03-27,70795,14,2,19,28,151,2.7142857142857144,3.834007647836308,"(3.999, 24.0]",Q1
36053,2020-03-28,70795,14,5,24,34,185,3.2857142857142856,4.641167152643952,"(3.999, 24.0]",Q1
36053,2020-03-29,70795,14,10,34,30,215,4.285714285714286,6.0536962860573285,"(3.999, 24.0]",Q1
36053,2020-03-30,70795,14,7,41,39,254,5.142857142857143,7.264435543268795,"(3.999, 24.0]",Q1
36053,2020-03-31,70795,14,10,51,55,309,6.285714285714286,8.87875455288408,"(3.999, 24.0]",Q1
36053,2020-04-01,70795,14,9,60,67,376,7.285714285714286,10.291283686297458,"(3.999, 24.0]",Q1
36053,2020-04-02,70795,14,10,70,70,446,7.571428571428571,10.69486343870128,"(3.999, 24.0]",Q1
36053,2020-04-03,70795,14,4,74,20,466,7.857142857142857,11.098443191105101,"(3.999, 24.0]",Q1
36053,2020-04-04,70795,14,5,79,28,494,7.857142857142857,11.098443191105101,"(3.999, 24.0]",Q1
36053,2020-04-05,70795,14,3,82,13,507,6.857142857142857,9.685914057691726,"(3.999, 24.0]",Q1
36053,2020-04-06,70795,14,6,88,64,571,6.714285714285714,9.484124181489815,"(3.999, 24.0]",Q1
36053,2020-04-07,70795,14,2,90,43,614,5.571428571428571,7.8698051718745266,"(3.999, 24.0]",Q1
36053,2020-04-08,70795,14,1,91,12,626,4.428571428571429,6.25548616225924,"(3.999, 24.0]",Q1
36053,2020-04-09,70795,14,8,99,54,680,4.142857142857143,5.8519064098554185,"(3.999, 24.0]",Q1
36053,2020-04-10,70795,14,0,99,7,687,3.5714285714285716,5.044746905047774,"(3.999, 24.0]",Q1
36053,2020-04-11,70795,14,2,101,9,696,3.142857142857143,4.43937727644204,"(3.999, 24.0]",Q1
36053,2020-04-12,70795,14,0,101,7,703,2.7142857142857144,3.834007647836308,"(3.999, 24.0]",Q1
36053,2020-04-13,70795,14,3,104,50,753,2.2857142857142856,3.2286380192305746,"(3.999, 24.0]",Q1
36053,2020-04-14,70795,14,1,105,4,757,2.142857142857143,3.0268481430286642,"(3.999, 24.0]",Q1
36053,2020-04-15,70795,14,0,105,7,764,2.0,2.8250582668267534,"(3.999, 24.0]",Q1
36053,2020-04-16,70795,14,0,105,2,766,0.8571428571428571,1.2107392572114657,"(3.999, 24.0]",Q1
36053,2020-04-17,70795,14,0,105,6,772,0.8571428571428571,1.2107392572114657,"(3.999, 24.0]",Q1
36053,2020-04-18,70795,14,1,106,7,779,0.7142857142857143,1.0089493810095547,"(3.999, 24.0]",Q1
36053,2020-04-19,70795,14,0,106,4,783,0.7142857142857143,1.0089493810095547,"(3.999, 24.0]",Q1
36053,2020-04-20,70795,14,0,106,1,784,0.2857142857142857,0.4035797524038218,"(3.999, 24.0]",Q1
36053,2020-04-21,70795,14,0,106,3,787,0.14285714285714285,0.2017898762019109,"(3.999, 24.0]",Q1
36053,2020-04-22,70795,14,0,106,7,794,0.14285714285714285,0.2017898762019109,"(3.999, 24.0]",Q1
36053,2020-04-23,70795,14,0,106,4,798,0.14285714285714285,0.2017898762019109,"(3.999, 24.0]",Q1
36053,2020-04-24,70795,14,15,121,294,1092,2.2857142857142856,3.2286380192305746,"(3.999, 24.0]",Q1
36053,2020-04-25,70795,14,2,123,22,1114,2.4285714285714284,3.430427895432486,"(3.999, 24.0]",Q1
36053,2020-04-26,70795,14,1,124,16,1130,2.5714285714285716,3.6322177716343975,"(3.999, 24.0]",Q1
36053,2020-04-27,70795,14,2,126,26,1156,2.857142857142857,4.035797524038219,"(3.999, 24.0]",Q1
36053,2020-04-28,70795,14,0,126,47,1203,2.857142857142857,4.035797524038219,"(3.999, 24.0]",Q1
36053,2020-04-29,70795,14,5,131,12,1215,3.5714285714285716,5.044746905047774,"(3.999, 24.0]",Q1
36053,2020-04-30,70795,14,8,139,51,1266,4.714285714285714,6.659065914663061,"(3.999, 24.0]",Q1
36053,2020-05-01,70795,14,10,149,54,1320,4.0,5.650116533653507,"(3.999, 24.0]",Q1
36053,2020-05-02,70795,14,2,151,26,1346,4.0,5.650116533653507,"(3.999, 24.0]",Q1
36053,2020-05-03,70795,14,66,217,141,1487,13.285714285714286,18.76645848677772,"(3.999, 24.0]",Q1
36053,2020-05-04,70795,14,6,223,43,1530,13.857142857142858,19.573617991585362,"(3.999, 24.0]",Q1
36053,2020-05-05,70795,14,8,231,192,1722,15.0,21.18793700120065,"(3.999, 24.0]",Q1
36053,2020-05-06,70795,14,15,246,204,1926,16.428571428571427,23.205835763219756,"(3.999, 24.0]",Q1
36053,2020-05-07,70795,14,3,249,95,2021,15.714285714285714,22.196886382210202,"(3.999, 24.0]",Q1
36053,2020-05-08,70795,14,1,250,50,2071,14.428571428571429,20.38077749639301,"(3.999, 24.0]",Q1
36053,2020-05-09,70795,14,1,251,37,2108,14.285714285714286,20.178987620191094,"(3.999, 24.0]",Q1
36053,2020-05-10,70795,14,0,251,23,2131,4.857142857142857,6.860855790864972,"(3.999, 24.0]",Q1
36053,2020-05-11,70795,14,0,251,17,2148,4.0,5.650116533653507,"(3.999, 24.0]",Q1
36053,2020-05-12,70795,14,2,253,79,2227,3.142857142857143,4.43937727644204,"(3.999, 24.0]",Q1
36053,2020-05-13,70795,14,2,255,61,2288,1.2857142857142858,1.8161088858171988,"(3.999, 24.0]",Q1
36053,2020-05-14,70795,14,1,256,30,2318,1.0,1.4125291334133767,"(3.999, 24.0]",Q1
36053,2020-05-15,70795,14,2,258,53,2371,1.1428571428571428,1.6143190096152873,"(3.999, 24.0]",Q1
36053,2020-05-16,70795,14,0,258,56,2427,1.0,1.4125291334133767,"(3.999, 24.0]",Q1
36053,2020-05-17,70795,14,0,258,44,2471,1.0,1.4125291334133767,"(3.999, 24.0]",Q1
36053,2020-05-18,70795,14,2,260,103,2574,1.2857142857142858,1.8161088858171988,"(3.999, 24.0]",Q1
36053,2020-05-19,70795,14,32,292,201,2775,5.571428571428571,7.8698051718745266,"(3.999, 24.0]",Q1
36053,2020-05-20,70795,14,2,294,101,2876,5.571428571428571,7.8698051718745266,"(3.999, 24.0]",Q1
36053,2020-05-21,70795,14,3,297,135,3011,5.857142857142857,8.273384924278348,"(3.999, 24.0]",Q1
36053,2020-05-22,70795,14,4,301,200,3211,6.142857142857143,8.676964676682172,"(3.999, 24.0]",Q1
36053,2020-05-23,70795,14,0,301,105,3316,6.142857142857143,8.676964676682172,"(3.999, 24.0]",Q1
36053,2020-05-24,70795,14,2,303,67,3383,6.428571428571429,9.080544429085993,"(3.999, 24.0]",Q1
36053,2020-05-25,70795,14,0,303,179,3562,6.142857142857143,8.676964676682172,"(3.999, 24.0]",Q1
36053,2020-05-26,70795,14,7,310,330,3892,2.5714285714285716,3.6322177716343975,"(3.999, 24.0]",Q1
36053,2020-05-27,70795,14,0,310,67,3959,2.2857142857142856,3.2286380192305746,"(3.999, 24.0]",Q1
36053,2020-05-28,70795,14,0,310,141,4100,1.8571428571428572,2.6232683906248426,"(3.999, 24.0]",Q1
36053,2020-05-29,70795,14,1,311,187,4287,1.4285714285714286,2.0178987620191093,"(3.999, 24.0]",Q1
36053,2020-05-30,70795,14,5,316,316,4603,2.142857142857143,3.0268481430286642,"(3.999, 24.0]",Q1
36053,2020-05-31,70795,14,0,316,138,4741,1.8571428571428572,2.6232683906248426,"(3.999, 24.0]",Q1
36053,2020-06-01,70795,14,1,317,98,4839,2.0,2.8250582668267534,"(3.999, 24.0]",Q1
36053,2020-06-02,70795,14,2,319,222,5061,1.2857142857142858,1.8161088858171988,"(3.999, 24.0]",Q1
36053,2020-06-03,70795,14,0,319,242,5303,1.2857142857142858,1.8161088858171988,"(3.999, 24.0]",Q1
36053,2020-06-04,70795,14,4,323,279,5582,1.8571428571428572,2.6232683906248426,"(3.999, 24.0]",Q1
36053,2020-06-05,70795,14,2,325,336,5918,2.0,2.8250582668267534,"(3.999, 24.0]",Q1
36053,2020-06-06,70795,14,2,327,123,6041,1.5714285714285714,2.21968863822102,"(3.999, 24.0]",Q1
36053,2020-06-07,70795,14,0,327,148,6189,1.5714285714285714,2.21968863822102,"(3.999, 24.0]",Q1
36055,2020-03-02,742474,49,0,0,0,0,0.0,0.0,"(37.5, 52.0]",Q3
36055,2020-03-03,742474,49,0,0,0,0,0.0,0.0,"(37.5, 52.0]",Q3
36055,2020-03-04,742474,49,0,0,0,0,0.0,0.0,"(37.5, 52.0]",Q3
36055,2020-03-05,742474,49,0,0,0,0,0.0,0.0,"(37.5, 52.0]",Q3
36055,2020-03-06,742474,49,0,0,0,0,0.0,0.0,"(37.5, 52.0]",Q3
36055,2020-03-07,742474,49,0,0,2,2,0.0,0.0,"(37.5, 52.0]",Q3
36055,2020-03-08,742474,49,0,0,1,3,0.0,0.0,"(37.5, 52.0]",Q3
36055,2020-03-09,742474,49,0,0,0,3,0.0,0.0,"(37.5, 52.0]",Q3
36055,2020-03-10,742474,49,0,0,0,3,0.0,0.0,"(37.5, 52.0]",Q3
36055,2020-03-11,742474,49,0,0,0,3,0.0,0.0,"(37.5, 52.0]",Q3
36055,2020-03-12,742474,49,1,1,10,13,0.14285714285714285,0.019240692988191217,"(37.5, 52.0]",Q3
36055,2020-03-13,742474,49,1,2,4,17,0.2857142857142857,0.03848138597638243,"(37.5, 52.0]",Q3
36055,2020-03-14,742474,49,0,2,2,19,0.2857142857142857,0.03848138597638243,"(37.5, 52.0]",Q3
36055,2020-03-15,742474,49,7,9,39,58,1.2857142857142858,0.17316623689372096,"(37.5, 52.0]",Q3
36055,2020-03-16,742474,49,1,10,29,87,1.4285714285714286,0.19240692988191216,"(37.5, 52.0]",Q3
36055,2020-03-17,742474,49,4,14,75,162,2.0,0.269369701834677,"(37.5, 52.0]",Q3
36055,2020-03-18,742474,49,13,27,153,315,3.857142857142857,0.5194987106811628,"(37.5, 52.0]",Q3
36055,2020-03-19,742474,49,5,32,193,508,4.428571428571429,0.5964614826339278,"(37.5, 52.0]",Q3
36055,2020-03-20,742474,49,10,42,148,656,5.714285714285714,0.7696277195276486,"(37.5, 52.0]",Q3
36055,2020-03-21,742474,49,15,57,246,902,7.857142857142857,1.0582381143505168,"(37.5, 52.0]",Q3
36055,2020-03-22,742474,49,19,76,416,1318,9.571428571428571,1.2891264302088115,"(37.5, 52.0]",Q3
36055,2020-03-23,742474,49,20,96,219,1537,12.285714285714286,1.6546995969844447,"(37.5, 52.0]",Q3
36055,2020-03-24,742474,49,22,118,172,1709,14.857142857142858,2.0010320707718865,"(37.5, 52.0]",Q3
36055,2020-03-25,742474,49,21,139,255,1964,16.0,2.154957614677416,"(37.5, 52.0]",Q3
36055,2020-03-26,742474,49,21,160,232,2196,18.285714285714285,2.4628087024884757,"(37.5, 52.0]",Q3
36055,2020-03-27,742474,49,32,192,253,2449,21.428571428571427,2.8861039482286825,"(37.5, 52.0]",Q3
36055,2020-03-28,742474,49,27,219,282,2731,23.142857142857142,3.116992264086977,"(37.5, 52.0]",Q3
36055,2020-03-29,742474,49,23,242,129,2860,23.714285714285715,3.193955036039742,"(37.5, 52.0]",Q3
36055,2020-03-30,742474,49,50,292,383,3243,28.0,3.7711758256854786,"(37.5, 52.0]",Q3
36055,2020-03-31,742474,49,57,349,356,3599,33.0,4.4446000802721715,"(37.5, 52.0]",Q3
36055,2020-04-01,742474,49,71,420,381,3980,40.142857142857146,5.406634729681732,"(37.5, 52.0]",Q3
36055,2020-04-02,742474,49,44,464,336,4316,43.42857142857143,5.849170668410131,"(37.5, 52.0]",Q3
36055,2020-04-03,742474,49,48,512,328,4644,45.714285714285715,6.157021756221189,"(37.5, 52.0]",Q3
36055,2020-04-04,742474,49,36,548,277,4921,47.0,6.33018799311491,"(37.5, 52.0]",Q3
36055,2020-04-05,742474,49,26,574,225,5146,47.42857142857143,6.387910072079484,"(37.5, 52.0]",Q3
36055,2020-04-06,742474,49,22,596,305,5451,43.42857142857143,5.849170668410131,"(37.5, 52.0]",Q3
36055,2020-04-07,742474,49,55,651,420,5871,43.142857142857146,5.810689282433748,"(37.5, 52.0]",Q3
36055,2020-04-08,742474,49,47,698,382,6253,39.714285714285715,5.348912650717158,"(37.5, 52.0]",Q3
36055,2020-04-09,742474,49,44,742,380,6633,39.714285714285715,5.348912650717158,"(37.5, 52.0]",Q3
36055,2020-04-10,742474,49,25,767,284,6917,36.42857142857143,4.90637671198876,"(37.5, 52.0]",Q3
36055,2020-04-11,742474,49,31,798,220,7137,35.714285714285715,4.810173247047804,"(37.5, 52.0]",Q3
36055,2020-04-12,742474,49,25,823,157,7294,35.57142857142857,4.790932554059613,"(37.5, 52.0]",Q3
36055,2020-04-13,742474,49,27,850,304,7598,36.285714285714285,4.887136019000569,"(37.5, 52.0]",Q3
36055,2020-04-14,742474,49,34,884,353,7951,33.285714285714285,4.483081466248553,"(37.5, 52.0]",Q3
36055,2020-04-15,742474,49,48,932,259,8210,33.42857142857143,4.502322159236745,"(37.5, 52.0]",Q3
36055,2020-04-16,742474,49,43,975,296,8506,33.285714285714285,4.483081466248553,"(37.5, 52.0]",Q3
36055,2020-04-17,742474,49,33,1008,260,8766,34.42857142857143,4.6370070101540835,"(37.5, 52.0]",Q3
36055,2020-04-18,742474,49,24,1032,202,8968,33.42857142857143,4.502322159236745,"(37.5, 52.0]",Q3
36055,2020-04-19,742474,49,22,1054,188,9156,33.0,4.4446000802721715,"(37.5, 52.0]",Q3
36055,2020-04-20,742474,49,16,1070,229,9385,31.428571428571427,4.232952457402067,"(37.5, 52.0]",Q3
36055,2020-04-21,742474,49,42,1112,409,9794,32.57142857142857,4.386878001307597,"(37.5, 52.0]",Q3
36055,2020-04-22,742474,49,40,1152,500,10294,31.428571428571427,4.232952457402067,"(37.5, 52.0]",Q3
36055,2020-04-23,742474,49,47,1199,470,10764,32.0,4.309915229354832,"(37.5, 52.0]",Q3
36055,2020-04-24,742474,49,86,1285,1134,11898,39.57142857142857,5.329671957728967,"(37.5, 52.0]",Q3
36055,2020-04-25,742474,49,31,1316,341,12239,40.57142857142857,5.464356808646306,"(37.5, 52.0]",Q3
36055,2020-04-26,742474,49,15,1331,234,12473,39.57142857142857,5.329671957728967,"(37.5, 52.0]",Q3
36055,2020-04-27,742474,49,40,1371,543,13016,43.0,5.791448589445556,"(37.5, 52.0]",Q3
36055,2020-04-28,742474,49,33,1404,530,13546,41.714285714285715,5.6182823525518355,"(37.5, 52.0]",Q3
36055,2020-04-29,742474,49,37,1441,469,14015,41.285714285714285,5.560560273587261,"(37.5, 52.0]",Q3
36055,2020-04-30,742474,49,37,1478,579,14594,39.857142857142854,5.368153343705349,"(37.5, 52.0]",Q3
36055,2020-05-01,742474,49,56,1534,520,15114,35.57142857142857,4.790932554059613,"(37.5, 52.0]",Q3
36055,2020-05-02,742474,49,32,1566,571,15685,35.714285714285715,4.810173247047804,"(37.5, 52.0]",Q3
36055,2020-05-03,742474,49,29,1595,914,16599,37.714285714285715,5.079542948882481,"(37.5, 52.0]",Q3
36055,2020-05-04,742474,49,28,1623,721,17320,36.0,4.848654633024187,"(37.5, 52.0]",Q3
36055,2020-05-05,742474,49,32,1655,842,18162,35.857142857142854,4.8294139400359954,"(37.5, 52.0]",Q3
36055,2020-05-06,742474,49,33,1688,1088,19250,35.285714285714285,4.75245116808323,"(37.5, 52.0]",Q3
36055,2020-05-07,742474,49,47,1735,1042,20292,36.714285714285715,4.944858097965143,"(37.5, 52.0]",Q3
36055,2020-05-08,742474,49,40,1775,1114,21406,34.42857142857143,4.6370070101540835,"(37.5, 52.0]",Q3
36055,2020-05-09,742474,49,46,1821,1148,22554,36.42857142857143,4.90637671198876,"(37.5, 52.0]",Q3
36055,2020-05-10,742474,49,29,1850,864,23418,36.42857142857143,4.90637671198876,"(37.5, 52.0]",Q3
36055,2020-05-11,742474,49,40,1890,797,24215,38.142857142857146,5.1372650278470555,"(37.5, 52.0]",Q3
36055,2020-05-12,742474,49,69,1959,1423,25638,43.42857142857143,5.849170668410131,"(37.5, 52.0]",Q3
36055,2020-05-13,742474,49,60,2019,1401,27039,47.285714285714285,6.368669379091293,"(37.5, 52.0]",Q3
36055,2020-05-14,742474,49,72,2091,1332,28371,50.857142857142854,6.849686703796073,"(37.5, 52.0]",Q3
36055,2020-05-15,742474,49,101,2192,1427,29798,59.57142857142857,8.023368976075737,"(37.5, 52.0]",Q3
36055,2020-05-16,742474,49,66,2258,1508,31306,62.42857142857143,8.408182835839563,"(37.5, 52.0]",Q3
36055,2020-05-17,742474,49,45,2303,1324,32630,64.71428571428571,8.71603392365062,"(37.5, 52.0]",Q3
36055,2020-05-18,742474,49,73,2376,1304,33934,69.42857142857143,9.350976792260932,"(37.5, 52.0]",Q3
36055,2020-05-19,742474,49,89,2465,2033,35967,72.28571428571429,9.735790652024756,"(37.5, 52.0]",Q3
36055,2020-05-20,742474,49,65,2530,1852,37819,73.0,9.831994116965712,"(37.5, 52.0]",Q3
36055,2020-05-21,742474,49,71,2601,2061,39880,72.85714285714286,9.81275342397752,"(37.5, 52.0]",Q3
36055,2020-05-22,742474,49,60,2661,1198,41078,67.0,9.02388501146168,"(37.5, 52.0]",Q3
36055,2020-05-23,742474,49,36,2697,846,41924,62.714285714285715,8.446664221815945,"(37.5, 52.0]",Q3
36055,2020-05-24,742474,49,36,2733,1729,43653,61.42857142857143,8.273497984922225,"(37.5, 52.0]",Q3
36055,2020-05-25,742474,49,29,2762,1595,45248,55.142857142857146,7.42690749344181,"(37.5, 52.0]",Q3
36055,2020-05-26,742474,49,29,2791,1297,46545,46.57142857142857,6.272465914150336,"(37.5, 52.0]",Q3
36055,2020-05-27,742474,49,33,2824,1632,48177,42.0,5.656763738528218,"(37.5, 52.0]",Q3
36055,2020-05-28,742474,49,36,2860,1127,49304,37.0,4.983339483941525,"(37.5, 52.0]",Q3
36055,2020-05-29,742474,49,49,2909,1322,50626,35.42857142857143,4.771691861071423,"(37.5, 52.0]",Q3
36055,2020-05-30,742474,49,33,2942,2828,53454,35.0,4.713969782106848,"(37.5, 52.0]",Q3
36055,2020-05-31,742474,49,22,2964,1994,55448,33.0,4.4446000802721715,"(37.5, 52.0]",Q3
36055,2020-06-01,742474,49,25,2989,2340,57788,32.42857142857143,4.367637308319407,"(37.5, 52.0]",Q3
36055,2020-06-02,742474,49,59,3048,3979,61767,36.714285714285715,4.944858097965143,"(37.5, 52.0]",Q3
36055,2020-06-03,742474,49,33,3081,2854,64621,36.714285714285715,4.944858097965143,"(37.5, 52.0]",Q3
36055,2020-06-04,742474,49,36,3117,2438,67059,36.714285714285715,4.944858097965143,"(37.5, 52.0]",Q3
36055,2020-06-05,742474,49,50,3167,4685,71744,36.857142857142854,4.964098790953334,"(37.5, 52.0]",Q3
36055,2020-06-06,742474,49,23,3190,3231,74975,35.42857142857143,4.771691861071423,"(37.5, 52.0]",Q3
36055,2020-06-07,742474,49,13,3203,2881,77856,34.142857142857146,4.598525624177701,"(37.5, 52.0]",Q3
36057,2020-03-02,49455,79,0,0,0,0,0.0,0.0,"(52.0, 100.0]",Q4
36057,2020-03-03,49455,79,0,0,0,0,0.0,0.0,"(52.0, 100.0]",Q4
36057,2020-03-04,49455,79,0,0,0,0,0.0,0.0,"(52.0, 100.0]",Q4
36057,2020-03-05,49455,79,0,0,0,0,0.0,0.0,"(52.0, 100.0]",Q4
36057,2020-03-06,49455,79,0,0,0,0,0.0,0.0,"(52.0, 100.0]",Q4
36057,2020-03-07,49455,79,0,0,0,0,0.0,0.0,"(52.0, 100.0]",Q4
36057,2020-03-08,49455,79,0,0,0,0,0.0,0.0,"(52.0, 100.0]",Q4
36057,2020-03-09,49455,79,0,0,0,0,0.0,0.0,"(52.0, 100.0]",Q4
36057,2020-03-10,49455,79,0,0,1,1,0.0,0.0,"(52.0, 100.0]",Q4
36057,2020-03-11,49455,79,0,0,1,2,0.0,0.0,"(52.0, 100.0]",Q4
36057,2020-03-12,49455,79,0,0,0,2,0.0,0.0,"(52.0, 100.0]",Q4
36057,2020-03-13,49455,79,0,0,0,2,0.0,0.0,"(52.0, 100.0]",Q4
36057,2020-03-14,49455,79,1,1,3,5,0.14285714285714285,0.2888628912286783,"(52.0, 100.0]",Q4
36057,2020-03-15,49455,79,0,1,4,9,0.14285714285714285,0.2888628912286783,"(52.0, 100.0]",Q4
36057,2020-03-16,49455,79,0,1,1,10,0.14285714285714285,0.2888628912286783,"(52.0, 100.0]",Q4
36057,2020-03-17,49455,79,1,2,14,24,0.2857142857142857,0.5777257824573566,"(52.0, 100.0]",Q4
36057,2020-03-18,49455,79,0,2,14,38,0.2857142857142857,0.5777257824573566,"(52.0, 100.0]",Q4
36057,2020-03-19,49455,79,0,2,4,42,0.2857142857142857,0.5777257824573566,"(52.0, 100.0]",Q4
36057,2020-03-20,49455,79,1,3,27,69,0.42857142857142855,0.8665886736860349,"(52.0, 100.0]",Q4
36057,2020-03-21,49455,79,0,3,20,89,0.2857142857142857,0.5777257824573566,"(52.0, 100.0]",Q4
36057,2020-03-22,49455,79,0,3,6,95,0.2857142857142857,0.5777257824573566,"(52.0, 100.0]",Q4
36057,2020-03-23,49455,79,0,3,5,100,0.2857142857142857,0.5777257824573566,"(52.0, 100.0]",Q4
36057,2020-03-24,49455,79,1,4,5,105,0.2857142857142857,0.5777257824573566,"(52.0, 100.0]",Q4
36057,2020-03-25,49455,79,1,5,5,110,0.42857142857142855,0.8665886736860349,"(52.0, 100.0]",Q4
36057,2020-03-26,49455,79,0,5,7,117,0.42857142857142855,0.8665886736860349,"(52.0, 100.0]",Q4
36057,2020-03-27,49455,79,0,5,10,127,0.2857142857142857,0.5777257824573566,"(52.0, 100.0]",Q4
36057,2020-03-28,49455,79,1,6,6,133,0.42857142857142855,0.8665886736860349,"(52.0, 100.0]",Q4
36057,2020-03-29,49455,79,0,6,2,135,0.42857142857142855,0.8665886736860349,"(52.0, 100.0]",Q4
36057,2020-03-30,49455,79,1,7,8,143,0.5714285714285714,1.1554515649147132,"(52.0, 100.0]",Q4
36057,2020-03-31,49455,79,0,7,4,147,0.42857142857142855,0.8665886736860349,"(52.0, 100.0]",Q4
36057,2020-04-01,49455,79,1,8,10,157,0.42857142857142855,0.8665886736860349,"(52.0, 100.0]",Q4
36057,2020-04-02,49455,79,2,10,8,165,0.7142857142857143,1.4443144561433916,"(52.0, 100.0]",Q4
36057,2020-04-03,49455,79,3,13,11,176,1.1428571428571428,2.3109031298294265,"(52.0, 100.0]",Q4
36057,2020-04-04,49455,79,2,15,14,190,1.2857142857142858,2.599766021058105,"(52.0, 100.0]",Q4
36057,2020-04-05,49455,79,0,15,8,198,1.2857142857142858,2.599766021058105,"(52.0, 100.0]",Q4
36057,2020-04-06,49455,79,3,18,20,218,1.5714285714285714,3.1774918035154616,"(52.0, 100.0]",Q4
36057,2020-04-07,49455,79,0,18,9,227,1.5714285714285714,3.1774918035154616,"(52.0, 100.0]",Q4
36057,2020-04-08,49455,79,10,28,24,251,2.857142857142857,5.777257824573566,"(52.0, 100.0]",Q4
36057,2020-04-09,49455,79,1,29,13,264,2.7142857142857144,5.488394933344888,"(52.0, 100.0]",Q4
36057,2020-04-10,49455,79,0,29,8,272,2.2857142857142856,4.621806259658853,"(52.0, 100.0]",Q4
36057,2020-04-11,49455,79,0,29,1,273,2.0,4.044080477201496,"(52.0, 100.0]",Q4
36057,2020-04-12,49455,79,0,29,2,275,2.0,4.044080477201496,"(52.0, 100.0]",Q4
36057,2020-04-13,49455,79,3,32,56,331,2.0,4.044080477201496,"(52.0, 100.0]",Q4
36057,2020-04-14,49455,79,0,32,0,331,2.0,4.044080477201496,"(52.0, 100.0]",Q4
36057,2020-04-15,49455,79,0,32,5,336,0.5714285714285714,1.1554515649147132,"(52.0, 100.0]",Q4
36057,2020-04-16,49455,79,1,33,10,346,0.5714285714285714,1.1554515649147132,"(52.0, 100.0]",Q4
36057,2020-04-17,49455,79,1,34,4,350,0.7142857142857143,1.4443144561433916,"(52.0, 100.0]",Q4
36057,2020-04-18,49455,79,1,35,4,354,0.8571428571428571,1.7331773473720697,"(52.0, 100.0]",Q4
36057,2020-04-19,49455,79,0,35,4,358,0.8571428571428571,1.7331773473720697,"(52.0, 100.0]",Q4
36057,2020-04-20,49455,79,2,37,3,361,0.7142857142857143,1.4443144561433916,"(52.0, 100.0]",Q4
36057,2020-04-21,49455,79,1,38,3,364,0.8571428571428571,1.7331773473720697,"(52.0, 100.0]",Q4
36057,2020-04-22,49455,79,1,39,7,371,1.0,2.022040238600748,"(52.0, 100.0]",Q4
36057,2020-04-23,49455,79,0,39,6,377,0.8571428571428571,1.7331773473720697,"(52.0, 100.0]",Q4
36057,2020-04-24,49455,79,7,46,226,603,1.7142857142857142,3.4663546947441395,"(52.0, 100.0]",Q4
36057,2020-04-25,49455,79,1,47,35,638,1.7142857142857142,3.4663546947441395,"(52.0, 100.0]",Q4
36057,2020-04-26,49455,79,0,47,9,647,1.7142857142857142,3.4663546947441395,"(52.0, 100.0]",Q4
36057,2020-04-27,49455,79,2,49,19,666,1.7142857142857142,3.4663546947441395,"(52.0, 100.0]",Q4
36057,2020-04-28,49455,79,2,51,18,684,1.8571428571428572,3.7552175859728183,"(52.0, 100.0]",Q4
36057,2020-04-29,49455,79,2,53,14,698,2.0,4.044080477201496,"(52.0, 100.0]",Q4
36057,2020-04-30,49455,79,1,54,29,727,2.142857142857143,4.332943368430175,"(52.0, 100.0]",Q4
36057,2020-05-01,49455,79,0,54,27,754,1.1428571428571428,2.3109031298294265,"(52.0, 100.0]",Q4
36057,2020-05-02,49455,79,2,56,53,807,1.2857142857142858,2.599766021058105,"(52.0, 100.0]",Q4
36057,2020-05-03,49455,79,0,56,19,826,1.2857142857142858,2.599766021058105,"(52.0, 100.0]",Q4
36057,2020-05-04,49455,79,5,61,28,854,1.7142857142857142,3.4663546947441395,"(52.0, 100.0]",Q4
36057,2020-05-05,49455,79,2,63,46,900,1.7142857142857142,3.4663546947441395,"(52.0, 100.0]",Q4
36057,2020-05-06,49455,79,0,63,34,934,1.4285714285714286,2.888628912286783,"(52.0, 100.0]",Q4
36057,2020-05-07,49455,79,1,64,36,970,1.4285714285714286,2.888628912286783,"(52.0, 100.0]",Q4
36057,2020-05-08,49455,79,2,66,36,1006,1.7142857142857142,3.4663546947441395,"(52.0, 100.0]",Q4
36057,2020-05-09,49455,79,1,67,33,1039,1.5714285714285714,3.1774918035154616,"(52.0, 100.0]",Q4
36057,2020-05-10,49455,79,0,67,30,1069,1.5714285714285714,3.1774918035154616,"(52.0, 100.0]",Q4
36057,2020-05-11,49455,79,0,67,62,1131,0.8571428571428571,1.7331773473720697,"(52.0, 100.0]",Q4
36057,2020-05-12,49455,79,1,68,115,1246,0.7142857142857143,1.4443144561433916,"(52.0, 100.0]",Q4
36057,2020-05-13,49455,79,1,69,177,1423,0.8571428571428571,1.7331773473720697,"(52.0, 100.0]",Q4
36057,2020-05-14,49455,79,3,72,46,1469,1.1428571428571428,2.3109031298294265,"(52.0, 100.0]",Q4
36057,2020-05-15,49455,79,3,75,93,1562,1.2857142857142858,2.599766021058105,"(52.0, 100.0]",Q4
36057,2020-05-16,49455,79,0,75,52,1614,1.1428571428571428,2.3109031298294265,"(52.0, 100.0]",Q4
36057,2020-05-17,49455,79,0,75,38,1652,1.1428571428571428,2.3109031298294265,"(52.0, 100.0]",Q4
36057,2020-05-18,49455,79,0,75,25,1677,1.1428571428571428,2.3109031298294265,"(52.0, 100.0]",Q4
36057,2020-05-19,49455,79,0,75,43,1720,1.0,2.022040238600748,"(52.0, 100.0]",Q4
36057,2020-05-20,49455,79,2,77,96,1816,1.1428571428571428,2.3109031298294265,"(52.0, 100.0]",Q4
36057,2020-05-21,49455,79,0,77,130,1946,0.7142857142857143,1.4443144561433916,"(52.0, 100.0]",Q4
36057,2020-05-22,49455,79,0,77,79,2025,0.2857142857142857,0.5777257824573566,"(52.0, 100.0]",Q4
36057,2020-05-23,49455,79,2,79,131,2156,0.5714285714285714,1.1554515649147132,"(52.0, 100.0]",Q4
36057,2020-05-24,49455,79,0,79,159,2315,0.5714285714285714,1.1554515649147132,"(52.0, 100.0]",Q4
36057,2020-05-25,49455,79,1,80,41,2356,0.7142857142857143,1.4443144561433916,"(52.0, 100.0]",Q4
36057,2020-05-26,49455,79,2,82,47,2403,1.0,2.022040238600748,"(52.0, 100.0]",Q4
36057,2020-05-27,49455,79,0,82,341,2744,0.7142857142857143,1.4443144561433916,"(52.0, 100.0]",Q4
36057,2020-05-28,49455,79,2,84,182,2926,1.0,2.022040238600748,"(52.0, 100.0]",Q4
36057,2020-05-29,49455,79,5,89,222,3148,1.7142857142857142,3.4663546947441395,"(52.0, 100.0]",Q4
36057,2020-05-30,49455,79,2,91,95,3243,1.7142857142857142,3.4663546947441395,"(52.0, 100.0]",Q4
36057,2020-05-31,49455,79,0,91,186,3429,1.7142857142857142,3.4663546947441395,"(52.0, 100.0]",Q4
36057,2020-06-01,49455,79,2,93,104,3533,1.8571428571428572,3.7552175859728183,"(52.0, 100.0]",Q4
36057,2020-06-02,49455,79,1,94,213,3746,1.7142857142857142,3.4663546947441395,"(52.0, 100.0]",Q4
36057,2020-06-03,49455,79,2,96,311,4057,2.0,4.044080477201496,"(52.0, 100.0]",Q4
36057,2020-06-04,49455,79,0,96,314,4371,1.7142857142857142,3.4663546947441395,"(52.0, 100.0]",Q4
36057,2020-06-05,49455,79,2,98,370,4741,1.2857142857142858,2.599766021058105,"(52.0, 100.0]",Q4
36057,2020-06-06,49455,79,2,100,226,4967,1.2857142857142858,2.599766021058105,"(52.0, 100.0]",Q4
36057,2020-06-07,49455,79,0,100,246,5213,1.2857142857142858,2.599766021058105,"(52.0, 100.0]",Q4
36059,2020-03-02,1358343,8,0,0,0,0,0.0,0.0,"(3.999, 24.0]",Q1
36059,2020-03-03,1358343,8,0,0,0,0,0.0,0.0,"(3.999, 24.0]",Q1
36059,2020-03-04,1358343,8,0,0,0,0,0.0,0.0,"(3.999, 24.0]",Q1
36059,2020-03-05,1358343,8,1,1,1,1,1.0,0.07361910798671617,"(3.999, 24.0]",Q1
36059,2020-03-06,1358343,8,3,4,10,11,3.0,0.2208573239601485,"(3.999, 24.0]",Q1
36059,2020-03-07,1358343,8,2,6,5,16,2.0,0.14723821597343234,"(3.999, 24.0]",Q1
36059,2020-03-08,1358343,8,4,10,11,27,1.4285714285714286,0.10517015426673738,"(3.999, 24.0]",Q1
36059,2020-03-09,1358343,8,4,14,15,42,2.0,0.14723821597343234,"(3.999, 24.0]",Q1
36059,2020-03-10,1358343,8,6,20,22,64,2.857142857142857,0.21034030853347477,"(3.999, 24.0]",Q1
36059,2020-03-11,1358343,8,11,31,58,122,4.428571428571429,0.3260274782268859,"(3.999, 24.0]",Q1
36059,2020-03-12,1358343,8,14,45,86,208,6.285714285714286,0.4627486787736445,"(3.999, 24.0]",Q1
36059,2020-03-13,1358343,8,19,64,100,308,8.571428571428571,0.6310209256004242,"(3.999, 24.0]",Q1
36059,2020-03-14,1358343,8,20,84,82,390,11.142857142857142,0.8203272032805515,"(3.999, 24.0]",Q1
36059,2020-03-15,1358343,8,23,107,109,499,13.857142857142858,1.0201504963873527,"(3.999, 24.0]",Q1
36059,2020-03-16,1358343,8,24,131,112,611,16.714285714285715,1.2304908049208274,"(3.999, 24.0]",Q1
36059,2020-03-17,1358343,8,52,183,218,829,23.285714285714285,1.7142735145478194,"(3.999, 24.0]",Q1
36059,2020-03-18,1358343,8,186,369,632,1461,48.285714285714285,3.5547512142157234,"(3.999, 24.0]",Q1
36059,2020-03-19,1358343,8,385,754,1036,2497,101.28571428571429,7.456563937511681,"(3.999, 24.0]",Q1
36059,2020-03-20,1358343,8,479,1233,1706,4203,167.0,12.2943910337816,"(3.999, 24.0]",Q1
36059,2020-03-21,1358343,8,667,1900,1968,6171,259.42857142857144,19.09890001483951,"(3.999, 24.0]",Q1
36059,2020-03-22,1358343,8,542,2442,1323,7494,333.57142857142856,24.557231021283176,"(3.999, 24.0]",Q1
36059,2020-03-23,1358343,8,427,2869,993,8487,391.14285714285717,28.7955882382327,"(3.999, 24.0]",Q1
36059,2020-03-24,1358343,8,416,3285,896,9383,443.14285714285717,32.62378185354194,"(3.999, 24.0]",Q1
36059,2020-03-25,1358343,8,629,3914,1735,11118,506.42857142857144,37.2828196875584,"(3.999, 24.0]",Q1
36059,2020-03-26,1358343,8,743,4657,1412,12530,557.5714285714286,41.0479112103076,"(3.999, 24.0]",Q1
36059,2020-03-27,1358343,8,880,5537,1827,14357,614.8571428571429,45.26523439640377,"(3.999, 24.0]",Q1
36059,2020-03-28,1358343,8,908,6445,2107,16464,649.2857142857143,47.799835114232145,"(3.999, 24.0]",Q1
36059,2020-03-29,1358343,8,899,7344,1830,18294,700.2857142857143,51.55440962155466,"(3.999, 24.0]",Q1
36059,2020-03-30,1358343,8,1200,8544,2261,20555,810.7142857142857,59.68406254637346,"(3.999, 24.0]",Q1
36059,2020-03-31,1358343,8,1010,9554,1845,22400,895.5714285714286,65.93116970981765,"(3.999, 24.0]",Q1
36059,2020-04-01,1358343,8,1033,10587,1908,24308,953.2857142857143,70.18004394219385,"(3.999, 24.0]",Q1
36059,2020-04-02,1358343,8,1437,12024,2663,26971,1052.4285714285713,77.47885264830542,"(3.999, 24.0]",Q1
36059,2020-04-03,1358343,8,1322,13346,2694,29665,1115.5714285714287,82.12737346689522,"(3.999, 24.0]",Q1
36059,2020-04-04,1358343,8,1052,14398,2195,31860,1136.142857142857,83.64182368833623,"(3.999, 24.0]",Q1
36059,2020-04-05,1358343,8,1218,15616,2363,34223,1181.7142857142858,86.99675160944517,"(3.999, 24.0]",Q1
36059,2020-04-06,1358343,8,994,16610,2097,36320,1152.2857142857142,84.83024643155036,"(3.999, 24.0]",Q1
36059,2020-04-07,1358343,8,1938,18548,4179,40499,1284.857142857143,94.5900367475036,"(3.999, 24.0]",Q1
36059,2020-04-08,1358343,8,1592,20140,3598,44097,1364.7142857142858,100.46904837101422,"(3.999, 24.0]",Q1
36059,2020-04-09,1358343,8,1372,21512,3021,47118,1355.4285714285713,99.78544236828041,"(3.999, 24.0]",Q1
36059,2020-04-10,1358343,8,1072,22584,2527,49645,1319.7142857142858,97.156188511612,"(3.999, 24.0]",Q1
36059,2020-04-11,1358343,8,969,23553,2307,51952,1307.857142857143,96.28327623119807,"(3.999, 24.0]",Q1
36059,2020-04-12,1358343,8,805,24358,2072,54024,1248.857142857143,91.93974885998182,"(3.999, 24.0]",Q1
36059,2020-04-13,1358343,8,892,25250,2283,56307,1234.2857142857142,90.86701328646109,"(3.999, 24.0]",Q1
36059,2020-04-14,1358343,8,1465,26715,3155,59462,1166.7142857142858,85.89246498964442,"(3.999, 24.0]",Q1
36059,2020-04-15,1358343,8,1057,27772,2814,62276,1090.2857142857142,80.26586173637396,"(3.999, 24.0]",Q1
36059,2020-04-16,1358343,8,767,28539,2386,64662,1003.8571428571429,73.90306740323636,"(3.999, 24.0]",Q1
36059,2020-04-17,1358343,8,641,29180,1973,66635,942.2857142857143,69.37023375433998,"(3.999, 24.0]",Q1
36059,2020-04-18,1358343,8,833,30013,2658,69293,922.8571428571429,67.93991965631236,"(3.999, 24.0]",Q1
36059,2020-04-19,1358343,8,664,30677,2196,71489,902.7142857142857,66.45702048115135,"(3.999, 24.0]",Q1
36059,2020-04-20,1358343,8,402,31079,1385,72874,832.7142857142857,61.30368292208122,"(3.999, 24.0]",Q1
36059,2020-04-21,1358343,8,476,31555,1697,74571,691.4285714285714,50.90235466510089,"(3.999, 24.0]",Q1
36059,2020-04-22,1358343,8,569,32124,1980,76551,621.7142857142857,45.770051136884106,"(3.999, 24.0]",Q1
36059,2020-04-23,1358343,8,641,32765,2787,79338,603.7142857142857,44.444907193123214,"(3.999, 24.0]",Q1
36059,2020-04-24,1358343,8,1033,33798,4225,83563,659.7142857142857,48.56757724037932,"(3.999, 24.0]",Q1
36059,2020-04-25,1358343,8,724,34522,3334,86897,644.1428571428571,47.42122255887188,"(3.999, 24.0]",Q1
36059,2020-04-26,1358343,8,343,34865,1871,88768,598.2857142857143,44.04526060690962,"(3.999, 24.0]",Q1
36059,2020-04-27,1358343,8,220,35085,1499,90267,572.2857142857143,42.131163799255,"(3.999, 24.0]",Q1
36059,2020-04-28,1358343,8,420,35505,2509,92776,564.2857142857143,41.54221093536127,"(3.999, 24.0]",Q1
36059,2020-04-29,1358343,8,349,35854,2424,95200,532.8571428571429,39.228467541493046,"(3.999, 24.0]",Q1
36059,2020-04-30,1358343,8,307,36161,2108,97308,485.14285714285717,35.71578438898401,"(3.999, 24.0]",Q1
36059,2020-05-01,1358343,8,358,36519,2384,99692,388.7142857142857,28.616798975979243,"(3.999, 24.0]",Q1
36059,2020-05-02,1358343,8,261,36780,2194,101886,322.57142857142856,23.747420833429302,"(3.999, 24.0]",Q1
36059,2020-05-03,1358343,8,185,36965,1736,103622,300.0,22.08573239601485,"(3.999, 24.0]",Q1
36059,2020-05-04,1358343,8,187,37152,1822,105444,295.2857142857143,21.738670886934617,"(3.999, 24.0]",Q1
36059,2020-05-05,1358343,8,198,37350,1765,107209,263.57142857142856,19.403893462213045,"(3.999, 24.0]",Q1
36059,2020-05-06,1358343,8,243,37593,2658,109867,248.42857142857142,18.289089826985627,"(3.999, 24.0]",Q1
36059,2020-05-07,1358343,8,219,37812,2050,111917,235.85714285714286,17.36359246943834,"(3.999, 24.0]",Q1
36059,2020-05-08,1358343,8,216,38028,2390,114307,215.57142857142858,15.870176278850673,"(3.999, 24.0]",Q1
36059,2020-05-09,1358343,8,189,38217,2260,116567,205.28571428571428,15.112951168130161,"(3.999, 24.0]",Q1
36059,2020-05-10,1358343,8,120,38337,1756,118323,196.0,14.42934516539637,"(3.999, 24.0]",Q1
36059,2020-05-11,1358343,8,97,38434,1558,119881,183.14285714285714,13.482813776995732,"(3.999, 24.0]",Q1
36059,2020-05-12,1358343,8,153,38587,2374,122255,176.71428571428572,13.009548082795416,"(3.999, 24.0]",Q1
36059,2020-05-13,1358343,8,156,38743,2633,124888,164.28571428571428,12.094567740674798,"(3.999, 24.0]",Q1
36059,2020-05-14,1358343,8,121,38864,2363,127251,150.28571428571428,11.063900228860772,"(3.999, 24.0]",Q1
36059,2020-05-15,1358343,8,169,39033,2478,129729,143.57142857142858,10.569600503807107,"(3.999, 24.0]",Q1
36059,2020-05-16,1358343,8,103,39136,2020,131749,131.28571428571428,9.665137177113165,"(3.999, 24.0]",Q1
36059,2020-05-17,1358343,8,89,39225,1749,133498,126.85714285714286,9.33910969888628,"(3.999, 24.0]",Q1
36059,2020-05-18,1358343,8,70,39295,1635,135133,123.0,9.055150282366089,"(3.999, 24.0]",Q1
36059,2020-05-19,1358343,8,73,39368,2281,137414,111.57142857142857,8.213789048232188,"(3.999, 24.0]",Q1
36059,2020-05-20,1358343,8,119,39487,3112,140526,106.28571428571429,7.824659477445262,"(3.999, 24.0]",Q1
36059,2020-05-21,1358343,8,121,39608,3097,143623,106.28571428571429,7.824659477445262,"(3.999, 24.0]",Q1
36059,2020-05-22,1358343,8,118,39726,4188,147811,99.0,7.2882916906849005,"(3.999, 24.0]",Q1
36059,2020-05-23,1358343,8,111,39837,3739,151550,100.14285714285714,7.37242781409829,"(3.999, 24.0]",Q1
36059,2020-05-24,1358343,8,70,39907,2891,154441,97.42857142857143,7.17260452099149,"(3.999, 24.0]",Q1
36059,2020-05-25,1358343,8,67,39974,2269,156710,97.0,7.141053474711468,"(3.999, 24.0]",Q1
36059,2020-05-26,1358343,8,60,40034,2390,159100,95.14285714285714,7.004332274164709,"(3.999, 24.0]",Q1
36059,2020-05-27,1358343,8,106,40140,4664,163764,93.28571428571429,6.867611073617952,"(3.999, 24.0]",Q1
36059,2020-05-28,1358343,8,86,40226,4760,168524,88.28571428571429,6.499515533684371,"(3.999, 24.0]",Q1
36059,2020-05-29,1358343,8,81,40307,4710,173234,83.0,6.110385962897443,"(3.999, 24.0]",Q1
36059,2020-05-30,1358343,8,89,40396,4112,177346,79.85714285714286,5.87901162351062,"(3.999, 24.0]",Q1
36059,2020-05-31,1358343,8,83,40479,3878,181224,81.71428571428571,6.015732824057378,"(3.999, 24.0]",Q1
36059,2020-06-01,1358343,8,93,40572,3851,185075,85.42857142857143,6.289175225150896,"(3.999, 24.0]",Q1
36059,2020-06-02,1358343,8,72,40644,4433,189508,87.14285714285714,6.41537941027098,"(3.999, 24.0]",Q1
36059,2020-06-03,1358343,8,69,40713,5104,194612,81.85714285714286,6.026249839484052,"(3.999, 24.0]",Q1
36059,2020-06-04,1358343,8,84,40797,5177,199789,81.57142857142857,6.005215808630704,"(3.999, 24.0]",Q1
36059,2020-06-05,1358343,8,56,40853,5533,205322,78.0,5.742290422963862,"(3.999, 24.0]",Q1
36059,2020-06-06,1358343,8,51,40904,4119,209441,72.57142857142857,5.342643836750259,"(3.999, 24.0]",Q1
36059,2020-06-07,1358343,8,43,40947,4033,213474,66.85714285714286,4.92196321968331,"(3.999, 24.0]",Q1
36061,2020-03-02,1628701,81,0,0,0,0,0.0,0.0,"(52.0, 100.0]",Q4
36061,2020-03-03,1628701,81,0,0,3,3,0.0,0.0,"(52.0, 100.0]",Q4
36061,2020-03-04,1628701,81,1,1,4,7,1.0,0.061398623811245896,"(52.0, 100.0]",Q4
36061,2020-03-05,1628701,81,1,2,18,25,1.0,0.061398623811245896,"(52.0, 100.0]",Q4
36061,2020-03-06,1628701,81,3,5,14,39,3.0,0.1841958714337377,"(52.0, 100.0]",Q4
36061,2020-03-07,1628701,81,0,5,22,61,0.0,0.0,"(52.0, 100.0]",Q4
36061,2020-03-08,1628701,81,0,5,24,85,0.7142857142857143,0.04385615986517564,"(52.0, 100.0]",Q4
36061,2020-03-09,1628701,81,7,12,47,132,1.7142857142857142,0.10525478367642153,"(52.0, 100.0]",Q4
36061,2020-03-10,1628701,81,12,24,78,210,3.4285714285714284,0.21050956735284307,"(52.0, 100.0]",Q4
36061,2020-03-11,1628701,81,3,27,70,280,3.7142857142857144,0.22805203129891333,"(52.0, 100.0]",Q4
36061,2020-03-12,1628701,81,18,45,186,466,6.142857142857143,0.37716297484051053,"(52.0, 100.0]",Q4
36061,2020-03-13,1628701,81,39,84,268,734,11.285714285714286,0.6929273258697751,"(52.0, 100.0]",Q4
36061,2020-03-14,1628701,81,28,112,193,927,15.285714285714286,0.9385218211147588,"(52.0, 100.0]",Q4
36061,2020-03-15,1628701,81,60,172,317,1244,23.857142857142858,1.4647957394968663,"(52.0, 100.0]",Q4
36061,2020-03-16,1628701,81,69,241,398,1642,32.714285714285715,2.0086121218250446,"(52.0, 100.0]",Q4
36061,2020-03-17,1628701,81,161,402,598,2240,54.0,3.3155256858072786,"(52.0, 100.0]",Q4
36061,2020-03-18,1628701,81,335,737,1074,3314,101.42857142857143,6.227574700854942,"(52.0, 100.0]",Q4
36061,2020-03-19,1628701,81,437,1174,1235,4549,161.28571428571428,9.902720897556659,"(52.0, 100.0]",Q4
36061,2020-03-20,1628701,81,370,1544,1263,5812,208.57142857142858,12.805998680631289,"(52.0, 100.0]",Q4
36061,2020-03-21,1628701,81,522,2066,1370,7182,279.14285714285717,17.13898727531064,"(52.0, 100.0]",Q4
36061,2020-03-22,1628701,81,607,2673,1367,8549,357.2857142857143,21.936851164560853,"(52.0, 100.0]",Q4
36061,2020-03-23,1628701,81,405,3078,990,9539,405.2857142857143,24.883985107500656,"(52.0, 100.0]",Q4
36061,2020-03-24,1628701,81,442,3520,1065,10604,445.42857142857144,27.34870129192353,"(52.0, 100.0]",Q4
36061,2020-03-25,1628701,81,542,4062,1232,11836,475.0,29.1643463103418,"(52.0, 100.0]",Q4
36061,2020-03-26,1628701,81,523,4585,1062,12898,487.2857142857143,29.91867226002282,"(52.0, 100.0]",Q4
36061,2020-03-27,1628701,81,631,5216,1314,14212,524.5714285714286,32.20796380498499,"(52.0, 100.0]",Q4
36061,2020-03-28,1628701,81,590,5806,1160,15372,534.2857142857143,32.80440757915138,"(52.0, 100.0]",Q4
36061,2020-03-29,1628701,81,422,6228,788,16160,507.85714285714283,31.181729664139876,"(52.0, 100.0]",Q4
36061,2020-03-30,1628701,81,648,6876,1422,17582,542.5714285714286,33.31313903358742,"(52.0, 100.0]",Q4
36061,2020-03-31,1628701,81,497,7373,1015,18597,550.4285714285714,33.79555679210435,"(52.0, 100.0]",Q4
36061,2020-04-01,1628701,81,470,7843,1002,19599,540.1428571428571,33.16402809004582,"(52.0, 100.0]",Q4
36061,2020-04-02,1628701,81,609,8452,1294,20893,552.4285714285714,33.918354039726836,"(52.0, 100.0]",Q4
36061,2020-04-03,1628701,81,848,9300,1820,22713,583.4285714285714,35.82171137787546,"(52.0, 100.0]",Q4
36061,2020-04-04,1628701,81,598,9898,1278,23991,584.5714285714286,35.89188123365974,"(52.0, 100.0]",Q4
36061,2020-04-05,1628701,81,542,10440,1162,25153,601.7142857142857,36.94442907042396,"(52.0, 100.0]",Q4
36061,2020-04-06,1628701,81,572,11012,1249,26402,590.8571428571429,36.27781544047329,"(52.0, 100.0]",Q4
36061,2020-04-07,1628701,81,492,11504,1257,27659,590.1428571428571,36.23395928060811,"(52.0, 100.0]",Q4
36061,2020-04-08,1628701,81,602,12106,1424,29083,609.0,37.391761901048746,"(52.0, 100.0]",Q4
36061,2020-04-09,1628701,81,616,12722,1659,30742,610.0,37.453160524859996,"(52.0, 100.0]",Q4
36061,2020-04-10,1628701,81,715,13437,1685,32427,591.0,36.286586672446326,"(52.0, 100.0]",Q4
36061,2020-04-11,1628701,81,708,14145,1783,34210,606.7142857142857,37.25142218948019,"(52.0, 100.0]",Q4
36061,2020-04-12,1628701,81,356,14501,1033,35243,580.1428571428571,35.61997304249565,"(52.0, 100.0]",Q4
36061,2020-04-13,1628701,81,379,14880,1206,36449,552.5714285714286,33.92712527169987,"(52.0, 100.0]",Q4
36061,2020-04-14,1628701,81,1737,16617,4068,40517,730.4285714285714,44.84730907812861,"(52.0, 100.0]",Q4
36061,2020-04-15,1628701,81,474,17091,1533,42050,712.1428571428571,43.72459138558011,"(52.0, 100.0]",Q4
36061,2020-04-16,1628701,81,399,17490,1476,43526,681.1428571428571,41.82123404743149,"(52.0, 100.0]",Q4
36061,2020-04-17,1628701,81,442,17932,1585,45111,642.1428571428571,39.4266877187929,"(52.0, 100.0]",Q4
36061,2020-04-18,1628701,81,288,18220,1093,46204,582.1428571428571,35.742770290118145,"(52.0, 100.0]",Q4
36061,2020-04-19,1628701,81,248,18468,954,47158,566.7142857142857,34.79547723703035,"(52.0, 100.0]",Q4
36061,2020-04-20,1628701,81,231,18699,1099,48257,545.5714285714286,33.49733490502115,"(52.0, 100.0]",Q4
36061,2020-04-21,1628701,81,326,19025,1430,49687,344.0,21.121126591068588,"(52.0, 100.0]",Q4
36061,2020-04-22,1628701,81,323,19348,1581,51268,322.42857142857144,19.79667056314028,"(52.0, 100.0]",Q4
36061,2020-04-23,1628701,81,506,19854,2654,53922,337.7142857142857,20.735192384255043,"(52.0, 100.0]",Q4
36061,2020-04-24,1628701,81,426,20280,2110,56032,335.42857142857144,20.594852672686482,"(52.0, 100.0]",Q4
36061,2020-04-25,1628701,81,493,20773,2354,58386,364.7142857142857,22.392955227158684,"(52.0, 100.0]",Q4
36061,2020-04-26,1628701,81,324,21097,2007,60393,375.57142857142856,23.05956885710935,"(52.0, 100.0]",Q4
36061,2020-04-27,1628701,81,215,21312,1650,62043,373.2857142857143,22.919229145540786,"(52.0, 100.0]",Q4
36061,2020-04-28,1628701,81,292,21604,2260,64303,368.42857142857144,22.621007258457595,"(52.0, 100.0]",Q4
36061,2020-04-29,1628701,81,316,21920,2299,66602,367.42857142857144,22.559608634646352,"(52.0, 100.0]",Q4
36061,2020-04-30,1628701,81,255,22175,2205,68807,331.57142857142856,20.35802940941453,"(52.0, 100.0]",Q4
36061,2020-05-01,1628701,81,321,22496,2606,71413,316.57142857142856,19.43705005224584,"(52.0, 100.0]",Q4
36061,2020-05-02,1628701,81,245,22741,2214,73627,281.14285714285717,17.261784522933134,"(52.0, 100.0]",Q4
36061,2020-05-03,1628701,81,159,22900,1524,75151,257.57142857142856,15.814531247382334,"(52.0, 100.0]",Q4
36061,2020-05-04,1628701,81,154,23054,2246,77397,248.85714285714286,15.279486097027192,"(52.0, 100.0]",Q4
36061,2020-05-05,1628701,81,203,23257,2499,79896,236.14285714285714,14.498846451427067,"(52.0, 100.0]",Q4
36061,2020-05-06,1628701,81,272,23529,2966,82862,229.85714285714286,14.112912244613522,"(52.0, 100.0]",Q4
36061,2020-05-07,1628701,81,201,23730,3036,85898,222.14285714285714,13.639265718069625,"(52.0, 100.0]",Q4
36061,2020-05-08,1628701,81,151,23881,2633,88531,197.85714285714286,12.148156282653654,"(52.0, 100.0]",Q4
36061,2020-05-09,1628701,81,96,23977,2336,90867,176.57142857142858,10.841242718671419,"(52.0, 100.0]",Q4
36061,2020-05-10,1628701,81,85,24062,1496,92363,166.0,10.192171552666819,"(52.0, 100.0]",Q4
36061,2020-05-11,1628701,81,129,24191,1984,94347,162.42857142857142,9.97289075334094,"(52.0, 100.0]",Q4
36061,2020-05-12,1628701,81,157,24348,2825,97172,155.85714285714286,9.569414082581325,"(52.0, 100.0]",Q4
36061,2020-05-13,1628701,81,177,24525,3697,100869,142.28571428571428,8.736147045142987,"(52.0, 100.0]",Q4
36061,2020-05-14,1628701,81,307,24832,3933,104802,157.42857142857142,9.66589763428471,"(52.0, 100.0]",Q4
36061,2020-05-15,1628701,81,150,24982,3469,108271,157.28571428571428,9.657126402311675,"(52.0, 100.0]",Q4
36061,2020-05-16,1628701,81,148,25130,3096,111367,164.71428571428572,10.113230464909503,"(52.0, 100.0]",Q4
36061,2020-05-17,1628701,81,86,25216,2019,113386,164.85714285714286,10.122001696882538,"(52.0, 100.0]",Q4
36061,2020-05-18,1628701,81,77,25293,2830,116216,157.42857142857142,9.66589763428471,"(52.0, 100.0]",Q4
36061,2020-05-19,1628701,81,98,25391,3685,119901,149.0,9.148394947875637,"(52.0, 100.0]",Q4
36061,2020-05-20,1628701,81,131,25522,4219,124120,142.42857142857142,8.744918277116023,"(52.0, 100.0]",Q4
36061,2020-05-21,1628701,81,150,25672,4363,128483,120.0,7.367834857349507,"(52.0, 100.0]",Q4
36061,2020-05-22,1628701,81,134,25806,4582,133065,117.71428571428571,7.227495145780945,"(52.0, 100.0]",Q4
36061,2020-05-23,1628701,81,103,25909,4187,137252,111.28571428571429,6.832789706994365,"(52.0, 100.0]",Q4
36061,2020-05-24,1628701,81,100,26009,3356,140608,113.28571428571429,6.955586954616857,"(52.0, 100.0]",Q4
36061,2020-05-25,1628701,81,83,26092,3635,144243,114.14285714285714,7.008214346455068,"(52.0, 100.0]",Q4
36061,2020-05-26,1628701,81,121,26213,3599,147842,117.42857142857143,7.209952681834875,"(52.0, 100.0]",Q4
36061,2020-05-27,1628701,81,134,26347,6888,154730,117.85714285714286,7.236266377753981,"(52.0, 100.0]",Q4
36061,2020-05-28,1628701,81,133,26480,7418,162148,115.42857142857143,7.0871554342123835,"(52.0, 100.0]",Q4
36061,2020-05-29,1628701,81,96,26576,5678,167826,110.0,6.753848619237048,"(52.0, 100.0]",Q4
36061,2020-05-30,1628701,81,77,26653,4425,172251,106.28571428571429,6.525796587938136,"(52.0, 100.0]",Q4
36061,2020-05-31,1628701,81,68,26721,4385,176636,101.71428571428571,6.2451171648010115,"(52.0, 100.0]",Q4
36061,2020-06-01,1628701,81,93,26814,5161,181797,103.14285714285714,6.332829484531363,"(52.0, 100.0]",Q4
36061,2020-06-02,1628701,81,72,26886,4211,186008,96.14285714285714,5.903039117852641,"(52.0, 100.0]",Q4
36061,2020-06-03,1628701,81,82,26968,4377,190385,88.71428571428571,5.446935055254814,"(52.0, 100.0]",Q4
36061,2020-06-04,1628701,81,69,27037,4416,194801,79.57142857142857,4.8855762089805665,"(52.0, 100.0]",Q4
36061,2020-06-05,1628701,81,85,27122,5322,200123,78.0,4.78909265727718,"(52.0, 100.0]",Q4
36061,2020-06-06,1628701,81,56,27178,4711,204834,75.0,4.604896785843442,"(52.0, 100.0]",Q4
36061,2020-06-07,1628701,81,39,27217,4045,208879,70.85714285714286,4.350531058625424,"(52.0, 100.0]",Q4
36063,2020-03-02,210433,34,0,0,0,0,0.0,0.0,"(24.0, 37.5]",Q2
36063,2020-03-03,210433,34,0,0,0,0,0.0,0.0,"(24.0, 37.5]",Q2
36063,2020-03-04,210433,34,0,0,0,0,0.0,0.0,"(24.0, 37.5]",Q2
36063,2020-03-05,210433,34,0,0,0,0,0.0,0.0,"(24.0, 37.5]",Q2
36063,2020-03-06,210433,34,0,0,0,0,0.0,0.0,"(24.0, 37.5]",Q2
36063,2020-03-07,210433,34,0,0,0,0,0.0,0.0,"(24.0, 37.5]",Q2
36063,2020-03-08,210433,34,0,0,1,1,0.0,0.0,"(24.0, 37.5]",Q2
36063,2020-03-09,210433,34,0,0,0,1,0.0,0.0,"(24.0, 37.5]",Q2
36063,2020-03-10,210433,34,0,0,0,1,0.0,0.0,"(24.0, 37.5]",Q2
36063,2020-03-11,210433,34,0,0,1,2,0.0,0.0,"(24.0, 37.5]",Q2
36063,2020-03-12,210433,34,0,0,1,3,0.0,0.0,"(24.0, 37.5]",Q2
36063,2020-03-13,210433,34,0,0,0,3,0.0,0.0,"(24.0, 37.5]",Q2
36063,2020-03-14,210433,34,0,0,1,4,0.0,0.0,"(24.0, 37.5]",Q2
36063,2020-03-15,210433,34,0,0,0,4,0.0,0.0,"(24.0, 37.5]",Q2
36063,2020-03-16,210433,34,0,0,1,5,0.0,0.0,"(24.0, 37.5]",Q2
36063,2020-03-17,210433,34,0,0,1,6,0.0,0.0,"(24.0, 37.5]",Q2
36063,2020-03-18,210433,34,1,1,10,16,0.14285714285714285,0.0678872338735573,"(24.0, 37.5]",Q2
36063,2020-03-19,210433,34,2,3,4,20,0.42857142857142855,0.20366170162067193,"(24.0, 37.5]",Q2
36063,2020-03-20,210433,34,1,4,6,26,0.5714285714285714,0.2715489354942292,"(24.0, 37.5]",Q2
36063,2020-03-21,210433,34,2,6,9,35,0.8571428571428571,0.40732340324134386,"(24.0, 37.5]",Q2
36063,2020-03-22,210433,34,4,10,38,73,1.4285714285714286,0.6788723387355731,"(24.0, 37.5]",Q2
36063,2020-03-23,210433,34,1,11,15,88,1.5714285714285714,0.7467595726091304,"(24.0, 37.5]",Q2
36063,2020-03-24,210433,34,1,12,16,104,1.7142857142857142,0.8146468064826877,"(24.0, 37.5]",Q2
36063,2020-03-25,210433,34,2,14,10,114,1.8571428571428572,0.882534040356245,"(24.0, 37.5]",Q2
36063,2020-03-26,210433,34,9,23,55,169,2.857142857142857,1.3577446774711461,"(24.0, 37.5]",Q2
36063,2020-03-27,210433,34,10,33,57,226,4.142857142857143,1.9687297823331622,"(24.0, 37.5]",Q2
36063,2020-03-28,210433,34,5,38,18,244,4.571428571428571,2.1723914839538336,"(24.0, 37.5]",Q2
36063,2020-03-29,210433,34,3,41,6,250,4.428571428571429,2.104504250080277,"(24.0, 37.5]",Q2
36063,2020-03-30,210433,34,1,42,15,265,4.428571428571429,2.104504250080277,"(24.0, 37.5]",Q2
36063,2020-03-31,210433,34,4,46,13,278,4.857142857142857,2.3081659517009485,"(24.0, 37.5]",Q2
36063,2020-04-01,210433,34,30,76,89,367,8.857142857142858,4.209008500160554,"(24.0, 37.5]",Q2
36063,2020-04-02,210433,34,18,94,61,428,10.142857142857142,4.819993605022569,"(24.0, 37.5]",Q2
36063,2020-04-03,210433,34,7,101,47,475,9.714285714285714,4.616331903401897,"(24.0, 37.5]",Q2
36063,2020-04-04,210433,34,15,116,54,529,11.142857142857142,5.29520424213747,"(24.0, 37.5]",Q2
36063,2020-04-05,210433,34,4,120,44,573,11.285714285714286,5.363091476011028,"(24.0, 37.5]",Q2
36063,2020-04-06,210433,34,6,126,44,617,12.0,5.702527645378814,"(24.0, 37.5]",Q2
36063,2020-04-07,210433,34,8,134,39,656,12.571428571428571,5.974076580873043,"(24.0, 37.5]",Q2
36063,2020-04-08,210433,34,12,146,53,709,10.0,4.7521063711490115,"(24.0, 37.5]",Q2
36063,2020-04-09,210433,34,10,156,79,788,8.857142857142858,4.209008500160554,"(24.0, 37.5]",Q2
36063,2020-04-10,210433,34,11,167,46,834,9.428571428571429,4.480557435654783,"(24.0, 37.5]",Q2
36063,2020-04-11,210433,34,16,183,62,896,9.571428571428571,4.548444669528339,"(24.0, 37.5]",Q2
36063,2020-04-12,210433,34,6,189,29,925,9.857142857142858,4.684219137275455,"(24.0, 37.5]",Q2
36063,2020-04-13,210433,34,8,197,48,973,10.142857142857142,4.819993605022569,"(24.0, 37.5]",Q2
36063,2020-04-14,210433,34,7,204,57,1030,10.0,4.7521063711490115,"(24.0, 37.5]",Q2
36063,2020-04-15,210433,34,12,216,82,1112,10.0,4.7521063711490115,"(24.0, 37.5]",Q2
36063,2020-04-16,210433,34,11,227,56,1168,10.142857142857142,4.819993605022569,"(24.0, 37.5]",Q2
36063,2020-04-17,210433,34,7,234,53,1221,9.571428571428571,4.548444669528339,"(24.0, 37.5]",Q2
36063,2020-04-18,210433,34,12,246,69,1290,9.0,4.2768957340341105,"(24.0, 37.5]",Q2
36063,2020-04-19,210433,34,9,255,48,1338,9.428571428571429,4.480557435654783,"(24.0, 37.5]",Q2
36063,2020-04-20,210433,34,5,260,53,1391,9.0,4.2768957340341105,"(24.0, 37.5]",Q2
36063,2020-04-21,210433,34,8,268,49,1440,9.142857142857142,4.344782967907667,"(24.0, 37.5]",Q2
36063,2020-04-22,210433,34,27,295,195,1635,11.285714285714286,5.363091476011028,"(24.0, 37.5]",Q2
36063,2020-04-23,210433,34,37,332,192,1827,15.0,7.128159556723517,"(24.0, 37.5]",Q2
36063,2020-04-24,210433,34,12,344,107,1934,15.714285714285714,7.467595726091304,"(24.0, 37.5]",Q2
36063,2020-04-25,210433,34,24,368,142,2076,17.428571428571427,8.28224253257399,"(24.0, 37.5]",Q2
36063,2020-04-26,210433,34,10,378,95,2171,17.571428571428573,8.35012976644755,"(24.0, 37.5]",Q2
36063,2020-04-27,210433,34,8,386,89,2260,18.0,8.553791468068221,"(24.0, 37.5]",Q2
36063,2020-04-28,210433,34,15,401,130,2390,19.0,9.029002105183123,"(24.0, 37.5]",Q2
36063,2020-04-29,210433,34,19,420,154,2544,17.857142857142858,8.485904234194663,"(24.0, 37.5]",Q2
36063,2020-04-30,210433,34,20,440,239,2783,15.428571428571429,7.33182125834419,"(24.0, 37.5]",Q2
36063,2020-05-01,210433,34,17,457,269,3052,16.142857142857142,7.671257427711976,"(24.0, 37.5]",Q2
36063,2020-05-02,210433,34,17,474,184,3236,15.142857142857142,7.196046790597075,"(24.0, 37.5]",Q2
36063,2020-05-03,210433,34,19,493,318,3554,16.428571428571427,7.80703189545909,"(24.0, 37.5]",Q2
36063,2020-05-04,210433,34,15,508,198,3752,17.428571428571427,8.28224253257399,"(24.0, 37.5]",Q2
36063,2020-05-05,210433,34,41,549,353,4105,21.142857142857142,10.047310613286482,"(24.0, 37.5]",Q2
36063,2020-05-06,210433,34,39,588,282,4387,24.0,11.405055290757629,"(24.0, 37.5]",Q2
36063,2020-05-07,210433,34,17,605,257,4644,23.571428571428573,11.201393589136957,"(24.0, 37.5]",Q2
36063,2020-05-08,210433,34,22,627,273,4917,24.285714285714285,11.540829758504742,"(24.0, 37.5]",Q2
36063,2020-05-09,210433,34,16,643,359,5276,24.142857142857142,11.472942524631186,"(24.0, 37.5]",Q2
36063,2020-05-10,210433,34,12,655,176,5452,23.142857142857142,10.997731887516284,"(24.0, 37.5]",Q2
36063,2020-05-11,210433,34,16,671,186,5638,23.285714285714285,11.065619121389842,"(24.0, 37.5]",Q2
36063,2020-05-12,210433,34,19,690,343,5981,20.142857142857142,9.57209997617158,"(24.0, 37.5]",Q2
36063,2020-05-13,210433,34,20,710,330,6311,17.428571428571427,8.28224253257399,"(24.0, 37.5]",Q2
36063,2020-05-14,210433,34,33,743,530,6841,19.714285714285715,9.36843827455091,"(24.0, 37.5]",Q2
36063,2020-05-15,210433,34,27,770,383,7224,20.428571428571427,9.707874443918696,"(24.0, 37.5]",Q2
36063,2020-05-16,210433,34,22,792,421,7645,21.285714285714285,10.11519784716004,"(24.0, 37.5]",Q2
36063,2020-05-17,210433,34,26,818,325,7970,23.285714285714285,11.065619121389842,"(24.0, 37.5]",Q2
36063,2020-05-18,210433,34,27,845,271,8241,24.857142857142858,11.812378693998973,"(24.0, 37.5]",Q2
36063,2020-05-19,210433,34,13,858,370,8611,24.0,11.405055290757629,"(24.0, 37.5]",Q2
36063,2020-05-20,210433,34,22,880,540,9151,24.285714285714285,11.540829758504742,"(24.0, 37.5]",Q2
36063,2020-05-21,210433,34,17,897,655,9806,22.0,10.454634016527825,"(24.0, 37.5]",Q2
36063,2020-05-22,210433,34,30,927,501,10307,22.428571428571427,10.658295718148496,"(24.0, 37.5]",Q2
36063,2020-05-23,210433,34,14,941,355,10662,21.285714285714285,10.11519784716004,"(24.0, 37.5]",Q2
36063,2020-05-24,210433,34,14,955,501,11163,19.571428571428573,9.300551040677352,"(24.0, 37.5]",Q2
36063,2020-05-25,210433,34,10,965,366,11529,17.142857142857142,8.146468064826877,"(24.0, 37.5]",Q2
36063,2020-05-26,210433,34,7,972,247,11776,16.285714285714285,7.7391446615855335,"(24.0, 37.5]",Q2
36063,2020-05-27,210433,34,12,984,502,12278,14.857142857142858,7.06027232284996,"(24.0, 37.5]",Q2
36063,2020-05-28,210433,34,24,1008,583,12861,15.857142857142858,7.535482959964861,"(24.0, 37.5]",Q2
36063,2020-05-29,210433,34,12,1020,447,13308,13.285714285714286,6.31351275024083,"(24.0, 37.5]",Q2
36063,2020-05-30,210433,34,17,1037,495,13803,13.714285714285714,6.517174451861502,"(24.0, 37.5]",Q2
36063,2020-05-31,210433,34,9,1046,420,14223,13.0,6.177738282493716,"(24.0, 37.5]",Q2
36063,2020-06-01,210433,34,2,1048,485,14708,11.857142857142858,5.634640411505257,"(24.0, 37.5]",Q2
36063,2020-06-02,210433,34,19,1067,655,15363,13.571428571428571,6.449287217987944,"(24.0, 37.5]",Q2
36063,2020-06-03,210433,34,18,1085,739,16102,14.428571428571429,6.856610621229289,"(24.0, 37.5]",Q2
36063,2020-06-04,210433,34,14,1099,726,16828,13.0,6.177738282493716,"(24.0, 37.5]",Q2
36063,2020-06-05,210433,34,10,1109,999,17827,12.714285714285714,6.0419638147466,"(24.0, 37.5]",Q2
36063,2020-06-06,210433,34,3,1112,521,18348,10.714285714285714,5.091542540516798,"(24.0, 37.5]",Q2
36063,2020-06-07,210433,34,4,1116,419,18767,10.0,4.7521063711490115,"(24.0, 37.5]",Q2
36065,2020-03-02,229577,56,0,0,0,0,0.0,0.0,"(52.0, 100.0]",Q4
36065,2020-03-03,229577,56,0,0,0,0,0.0,0.0,"(52.0, 100.0]",Q4
36065,2020-03-04,229577,56,0,0,2,2,0.0,0.0,"(52.0, 100.0]",Q4
36065,2020-03-05,229577,56,0,0,0,2,0.0,0.0,"(52.0, 100.0]",Q4
36065,2020-03-06,229577,56,0,0,0,2,0.0,0.0,"(52.0, 100.0]",Q4
36065,2020-03-07,229577,56,0,0,0,2,0.0,0.0,"(52.0, 100.0]",Q4
36065,2020-03-08,229577,56,0,0,0,2,0.0,0.0,"(52.0, 100.0]",Q4
36065,2020-03-09,229577,56,0,0,0,2,0.0,0.0,"(52.0, 100.0]",Q4
36065,2020-03-10,229577,56,0,0,0,2,0.0,0.0,"(52.0, 100.0]",Q4
36065,2020-03-11,229577,56,0,0,1,3,0.0,0.0,"(52.0, 100.0]",Q4
36065,2020-03-12,229577,56,0,0,1,4,0.0,0.0,"(52.0, 100.0]",Q4
36065,2020-03-13,229577,56,0,0,1,5,0.0,0.0,"(52.0, 100.0]",Q4
36065,2020-03-14,229577,56,0,0,1,6,0.0,0.0,"(52.0, 100.0]",Q4
36065,2020-03-15,229577,56,0,0,3,9,0.0,0.0,"(52.0, 100.0]",Q4
36065,2020-03-16,229577,56,0,0,1,10,0.0,0.0,"(52.0, 100.0]",Q4
36065,2020-03-17,229577,56,0,0,4,14,0.0,0.0,"(52.0, 100.0]",Q4
36065,2020-03-18,229577,56,2,2,14,28,0.2857142857142857,0.12445248684070517,"(52.0, 100.0]",Q4
36065,2020-03-19,229577,56,0,2,7,35,0.2857142857142857,0.12445248684070517,"(52.0, 100.0]",Q4
36065,2020-03-20,229577,56,2,4,59,94,0.5714285714285714,0.24890497368141035,"(52.0, 100.0]",Q4
36065,2020-03-21,229577,56,1,5,30,124,0.7142857142857143,0.31113121710176295,"(52.0, 100.0]",Q4
36065,2020-03-22,229577,56,2,7,36,160,1.0,0.43558370394246815,"(52.0, 100.0]",Q4
36065,2020-03-23,229577,56,1,8,24,184,1.1428571428571428,0.4978099473628207,"(52.0, 100.0]",Q4
36065,2020-03-24,229577,56,1,9,48,232,1.2857142857142858,0.5600361907831733,"(52.0, 100.0]",Q4
36065,2020-03-25,229577,56,4,13,22,254,1.5714285714285714,0.6844886776238784,"(52.0, 100.0]",Q4
36065,2020-03-26,229577,56,0,13,41,295,1.5714285714285714,0.6844886776238784,"(52.0, 100.0]",Q4
36065,2020-03-27,229577,56,10,23,43,338,2.7142857142857144,1.1822986249866991,"(52.0, 100.0]",Q4
36065,2020-03-28,229577,56,3,26,26,364,3.0,1.3067511118274042,"(52.0, 100.0]",Q4
36065,2020-03-29,229577,56,8,34,26,390,3.857142857142857,1.6801085723495197,"(52.0, 100.0]",Q4
36065,2020-03-30,229577,56,6,40,57,447,4.571428571428571,1.9912397894512828,"(52.0, 100.0]",Q4
36065,2020-03-31,229577,56,10,50,58,505,5.857142857142857,2.551275980234456,"(52.0, 100.0]",Q4
36065,2020-04-01,229577,56,11,61,82,587,6.857142857142857,2.986859684176924,"(52.0, 100.0]",Q4
36065,2020-04-02,229577,56,10,71,77,664,8.285714285714286,3.6091221183804505,"(52.0, 100.0]",Q4
36065,2020-04-03,229577,56,9,80,58,722,8.142857142857142,3.546895874960097,"(52.0, 100.0]",Q4
36065,2020-04-04,229577,56,7,87,55,777,8.714285714285714,3.7958008486415076,"(52.0, 100.0]",Q4
36065,2020-04-05,229577,56,13,100,87,864,9.428571428571429,4.106932065743271,"(52.0, 100.0]",Q4
36065,2020-04-06,229577,56,18,118,90,954,11.142857142857142,4.853646986787501,"(52.0, 100.0]",Q4
36065,2020-04-07,229577,56,7,125,59,1013,10.714285714285714,4.666968256526443,"(52.0, 100.0]",Q4
36065,2020-04-08,229577,56,33,158,104,1117,13.857142857142858,6.035945611774201,"(52.0, 100.0]",Q4
36065,2020-04-09,229577,56,14,172,85,1202,14.428571428571429,6.284850585455611,"(52.0, 100.0]",Q4
36065,2020-04-10,229577,56,9,181,42,1244,14.428571428571429,6.284850585455611,"(52.0, 100.0]",Q4
36065,2020-04-11,229577,56,14,195,83,1327,15.428571428571429,6.720434289398079,"(52.0, 100.0]",Q4
36065,2020-04-12,229577,56,11,206,61,1388,15.142857142857142,6.5959818025573735,"(52.0, 100.0]",Q4
36065,2020-04-13,229577,56,23,229,100,1488,15.857142857142858,6.907113019659137,"(52.0, 100.0]",Q4
36065,2020-04-14,229577,56,17,246,79,1567,17.285714285714285,7.529375453862662,"(52.0, 100.0]",Q4
36065,2020-04-15,229577,56,3,249,32,1599,13.0,5.662588151252086,"(52.0, 100.0]",Q4
36065,2020-04-16,229577,56,12,261,82,1681,12.714285714285714,5.538135664411381,"(52.0, 100.0]",Q4
36065,2020-04-17,229577,56,7,268,85,1766,12.428571428571429,5.413683177570675,"(52.0, 100.0]",Q4
36065,2020-04-18,229577,56,7,275,52,1818,11.428571428571429,4.978099473628207,"(52.0, 100.0]",Q4
36065,2020-04-19,229577,56,4,279,75,1893,10.428571428571429,4.542515769685739,"(52.0, 100.0]",Q4
36065,2020-04-20,229577,56,5,284,133,2026,7.857142857142857,3.422443388119392,"(52.0, 100.0]",Q4
36065,2020-04-21,229577,56,17,301,117,2143,7.857142857142857,3.422443388119392,"(52.0, 100.0]",Q4
36065,2020-04-22,229577,56,16,317,174,2317,9.714285714285714,4.231384552583975,"(52.0, 100.0]",Q4
36065,2020-04-23,229577,56,6,323,67,2384,8.857142857142858,3.8580270920618607,"(52.0, 100.0]",Q4
36065,2020-04-24,229577,56,41,364,401,2785,13.714285714285714,5.973719368353848,"(52.0, 100.0]",Q4
36065,2020-04-25,229577,56,20,384,112,2897,15.571428571428571,6.782660532818432,"(52.0, 100.0]",Q4
36065,2020-04-26,229577,56,13,397,128,3025,16.857142857142858,7.342696723601605,"(52.0, 100.0]",Q4
36065,2020-04-27,229577,56,14,411,132,3157,18.142857142857142,7.902732914384779,"(52.0, 100.0]",Q4
36065,2020-04-28,229577,56,11,422,124,3281,17.285714285714285,7.529375453862662,"(52.0, 100.0]",Q4
36065,2020-04-29,229577,56,17,439,145,3426,17.428571428571427,7.591601697283015,"(52.0, 100.0]",Q4
36065,2020-04-30,229577,56,12,451,149,3575,18.285714285714285,7.964959157805131,"(52.0, 100.0]",Q4
36065,2020-05-01,229577,56,23,474,185,3760,15.714285714285714,6.844886776238784,"(52.0, 100.0]",Q4
36065,2020-05-02,229577,56,15,489,149,3909,15.0,6.533755559137022,"(52.0, 100.0]",Q4
36065,2020-05-03,229577,56,61,550,241,4150,21.857142857142858,9.520615243313946,"(52.0, 100.0]",Q4
36065,2020-05-04,229577,56,24,574,247,4397,23.285714285714285,10.14287767751747,"(52.0, 100.0]",Q4
36065,2020-05-05,229577,56,5,579,234,4631,22.428571428571427,9.769520216995355,"(52.0, 100.0]",Q4
36065,2020-05-06,229577,56,30,609,375,5006,24.285714285714285,10.57846138145994,"(52.0, 100.0]",Q4
36065,2020-05-07,229577,56,11,620,323,5329,24.142857142857142,10.516235138039587,"(52.0, 100.0]",Q4
36065,2020-05-08,229577,56,18,638,296,5625,23.428571428571427,10.205103920937823,"(52.0, 100.0]",Q4
36065,2020-05-09,229577,56,22,660,329,5954,24.428571428571427,10.640687624880291,"(52.0, 100.0]",Q4
36065,2020-05-10,229577,56,9,669,269,6223,17.0,7.404922967021958,"(52.0, 100.0]",Q4
36065,2020-05-11,229577,56,7,676,161,6384,14.571428571428571,6.347076828875964,"(52.0, 100.0]",Q4
36065,2020-05-12,229577,56,10,686,397,6781,15.285714285714286,6.6582080459777275,"(52.0, 100.0]",Q4
36065,2020-05-13,229577,56,12,698,376,7157,12.714285714285714,5.538135664411381,"(52.0, 100.0]",Q4
36065,2020-05-14,229577,56,15,713,268,7425,13.285714285714286,5.787040638092791,"(52.0, 100.0]",Q4
36065,2020-05-15,229577,56,38,751,342,7767,16.142857142857142,7.031565506499843,"(52.0, 100.0]",Q4
36065,2020-05-16,229577,56,9,760,209,7976,14.285714285714286,6.2226243420352585,"(52.0, 100.0]",Q4
36065,2020-05-17,229577,56,12,772,318,8294,14.714285714285714,6.409303072296317,"(52.0, 100.0]",Q4
36065,2020-05-18,229577,56,13,785,326,8620,15.571428571428571,6.782660532818432,"(52.0, 100.0]",Q4
36065,2020-05-19,229577,56,17,802,775,9395,16.571428571428573,7.218244236760901,"(52.0, 100.0]",Q4
36065,2020-05-20,229577,56,15,817,779,10174,17.0,7.404922967021958,"(52.0, 100.0]",Q4
36065,2020-05-21,229577,56,11,828,815,10989,16.428571428571427,7.156017993340547,"(52.0, 100.0]",Q4
36065,2020-05-22,229577,56,36,864,1305,12294,16.142857142857142,7.031565506499843,"(52.0, 100.0]",Q4
36065,2020-05-23,229577,56,14,878,659,12953,16.857142857142858,7.342696723601605,"(52.0, 100.0]",Q4
36065,2020-05-24,229577,56,27,905,930,13883,19.0,8.276090374906893,"(52.0, 100.0]",Q4
36065,2020-05-25,229577,56,12,917,427,14310,18.857142857142858,8.213864131486542,"(52.0, 100.0]",Q4
36065,2020-05-26,229577,56,12,929,488,14798,18.142857142857142,7.902732914384779,"(52.0, 100.0]",Q4
36065,2020-05-27,229577,56,30,959,927,15725,20.285714285714285,8.836126565690067,"(52.0, 100.0]",Q4
36065,2020-05-28,229577,56,29,988,1284,17009,22.857142857142858,9.956198947256414,"(52.0, 100.0]",Q4
36065,2020-05-29,229577,56,18,1006,757,17766,20.285714285714285,8.836126565690067,"(52.0, 100.0]",Q4
36065,2020-05-30,229577,56,21,1027,1108,18874,21.285714285714285,9.271710269632536,"(52.0, 100.0]",Q4
36065,2020-05-31,229577,56,9,1036,677,19551,18.714285714285715,8.151637888066189,"(52.0, 100.0]",Q4
36065,2020-06-01,229577,56,13,1049,613,20164,18.857142857142858,8.213864131486542,"(52.0, 100.0]",Q4
36065,2020-06-02,229577,56,9,1058,1128,21292,18.428571428571427,8.027185401225482,"(52.0, 100.0]",Q4
36065,2020-06-03,229577,56,11,1069,892,22184,15.714285714285714,6.844886776238784,"(52.0, 100.0]",Q4
36065,2020-06-04,229577,56,8,1077,1050,23234,12.714285714285714,5.538135664411381,"(52.0, 100.0]",Q4
36065,2020-06-05,229577,56,50,1127,1505,24739,17.285714285714285,7.529375453862662,"(52.0, 100.0]",Q4
36065,2020-06-06,229577,56,16,1143,1276,26015,16.571428571428573,7.218244236760901,"(52.0, 100.0]",Q4
36065,2020-06-07,229577,56,27,1170,1207,27222,19.142857142857142,8.338316618327246,"(52.0, 100.0]",Q4
36067,2020-03-02,461809,45,0,0,0,0,0.0,0.0,"(37.5, 52.0]",Q3
36067,2020-03-03,461809,45,0,0,0,0,0.0,0.0,"(37.5, 52.0]",Q3
36067,2020-03-04,461809,45,0,0,0,0,0.0,0.0,"(37.5, 52.0]",Q3
36067,2020-03-05,461809,45,0,0,0,0,0.0,0.0,"(37.5, 52.0]",Q3
36067,2020-03-06,461809,45,0,0,0,0,0.0,0.0,"(37.5, 52.0]",Q3
36067,2020-03-07,461809,45,0,0,0,0,0.0,0.0,"(37.5, 52.0]",Q3
36067,2020-03-08,461809,45,0,0,0,0,0.0,0.0,"(37.5, 52.0]",Q3
36067,2020-03-09,461809,45,0,0,1,1,0.0,0.0,"(37.5, 52.0]",Q3
36067,2020-03-10,461809,45,0,0,0,1,0.0,0.0,"(37.5, 52.0]",Q3
36067,2020-03-11,461809,45,0,0,3,4,0.0,0.0,"(37.5, 52.0]",Q3
36067,2020-03-12,461809,45,0,0,1,5,0.0,0.0,"(37.5, 52.0]",Q3
36067,2020-03-13,461809,45,0,0,9,14,0.0,0.0,"(37.5, 52.0]",Q3
36067,2020-03-14,461809,45,0,0,18,32,0.0,0.0,"(37.5, 52.0]",Q3
36067,2020-03-15,461809,45,1,1,27,59,0.14285714285714285,0.030934248327153187,"(37.5, 52.0]",Q3
36067,2020-03-16,461809,45,1,2,55,114,0.2857142857142857,0.061868496654306375,"(37.5, 52.0]",Q3
36067,2020-03-17,461809,45,0,2,15,129,0.2857142857142857,0.061868496654306375,"(37.5, 52.0]",Q3
36067,2020-03-18,461809,45,3,5,98,227,0.7142857142857143,0.15467124163576593,"(37.5, 52.0]",Q3
36067,2020-03-19,461809,45,3,8,60,287,1.1428571428571428,0.2474739866172255,"(37.5, 52.0]",Q3
36067,2020-03-20,461809,45,9,17,133,420,2.4285714285714284,0.5258822215616041,"(37.5, 52.0]",Q3
36067,2020-03-21,461809,45,12,29,157,577,4.142857142857143,0.8970932014874425,"(37.5, 52.0]",Q3
36067,2020-03-22,461809,45,23,52,538,1115,7.285714285714286,1.5776466646848126,"(37.5, 52.0]",Q3
36067,2020-03-23,461809,45,8,60,129,1244,8.285714285714286,1.794186402974885,"(37.5, 52.0]",Q3
36067,2020-03-24,461809,45,5,65,124,1368,9.0,1.9488576446106507,"(37.5, 52.0]",Q3
36067,2020-03-25,461809,45,18,83,266,1634,11.142857142857142,2.4128713695179482,"(37.5, 52.0]",Q3
36067,2020-03-26,461809,45,32,115,444,2078,15.285714285714286,3.309964571005391,"(37.5, 52.0]",Q3
36067,2020-03-27,461809,45,14,129,352,2430,16.0,3.464635812641157,"(37.5, 52.0]",Q3
36067,2020-03-28,461809,45,23,152,487,2917,17.571428571428573,3.804912544239842,"(37.5, 52.0]",Q3
36067,2020-03-29,461809,45,28,180,206,3123,18.285714285714285,3.959583785875608,"(37.5, 52.0]",Q3
36067,2020-03-30,461809,45,14,194,139,3262,19.142857142857142,4.145189275838527,"(37.5, 52.0]",Q3
36067,2020-03-31,461809,45,23,217,163,3425,21.714285714285715,4.702005745727285,"(37.5, 52.0]",Q3
36067,2020-04-01,461809,45,17,234,191,3616,21.571428571428573,4.671071497400131,"(37.5, 52.0]",Q3
36067,2020-04-02,461809,45,18,252,195,3811,19.571428571428573,4.237992020819987,"(37.5, 52.0]",Q3
36067,2020-04-03,461809,45,10,262,221,4032,19.0,4.114255027511374,"(37.5, 52.0]",Q3
36067,2020-04-04,461809,45,6,268,131,4163,16.571428571428573,3.58837280594977,"(37.5, 52.0]",Q3
36067,2020-04-05,461809,45,3,271,89,4252,13.0,2.81501659777094,"(37.5, 52.0]",Q3
36067,2020-04-06,461809,45,64,335,689,4941,20.142857142857142,4.361729014128599,"(37.5, 52.0]",Q3
36067,2020-04-07,461809,45,12,347,126,5067,18.571428571428573,4.021452282529914,"(37.5, 52.0]",Q3
36067,2020-04-08,461809,45,11,358,245,5312,17.714285714285715,3.8358467925669952,"(37.5, 52.0]",Q3
36067,2020-04-09,461809,45,11,369,148,5460,16.714285714285715,3.619307054276923,"(37.5, 52.0]",Q3
36067,2020-04-10,461809,45,11,380,116,5576,16.857142857142858,3.6502413026040763,"(37.5, 52.0]",Q3
36067,2020-04-11,461809,45,17,397,169,5745,18.428571428571427,3.9905180342027604,"(37.5, 52.0]",Q3
36067,2020-04-12,461809,45,19,416,142,5887,20.714285714285715,4.485466007437212,"(37.5, 52.0]",Q3
36067,2020-04-13,461809,45,15,431,120,6007,13.714285714285714,2.9696878394067054,"(37.5, 52.0]",Q3
36067,2020-04-14,461809,45,18,449,219,6226,14.571428571428571,3.1552933293696253,"(37.5, 52.0]",Q3
36067,2020-04-15,461809,45,13,462,134,6360,14.857142857142858,3.217161826023932,"(37.5, 52.0]",Q3
36067,2020-04-16,461809,45,21,483,181,6541,16.285714285714285,3.5265043092954627,"(37.5, 52.0]",Q3
36067,2020-04-17,461809,45,9,492,152,6693,16.0,3.464635812641157,"(37.5, 52.0]",Q3
36067,2020-04-18,461809,45,6,498,118,6811,14.428571428571429,3.124359081042472,"(37.5, 52.0]",Q3
36067,2020-04-19,461809,45,11,509,113,6924,13.285714285714286,2.8768850944252464,"(37.5, 52.0]",Q3
36067,2020-04-20,461809,45,5,514,101,7025,11.857142857142858,2.5675426111537147,"(37.5, 52.0]",Q3
36067,2020-04-21,461809,45,12,526,152,7177,11.0,2.3819371211907954,"(37.5, 52.0]",Q3
36067,2020-04-22,461809,45,74,600,705,7882,19.714285714285715,4.26892626914714,"(37.5, 52.0]",Q3
36067,2020-04-23,461809,45,39,639,722,8604,22.285714285714285,4.8257427390358965,"(37.5, 52.0]",Q3
36067,2020-04-24,461809,45,25,664,530,9134,24.571428571428573,5.320690712270348,"(37.5, 52.0]",Q3
36067,2020-04-25,461809,45,28,692,280,9414,27.714285714285715,6.001244175467718,"(37.5, 52.0]",Q3
36067,2020-04-26,461809,45,34,726,256,9670,31.0,6.712731886992242,"(37.5, 52.0]",Q3
36067,2020-04-27,461809,45,16,742,268,9938,32.57142857142857,7.053008618590925,"(37.5, 52.0]",Q3
36067,2020-04-28,461809,45,40,782,386,10324,36.57142857142857,7.919167571751216,"(37.5, 52.0]",Q3
36067,2020-04-29,461809,45,50,832,343,10667,33.142857142857146,7.17674561189954,"(37.5, 52.0]",Q3
36067,2020-04-30,461809,45,28,860,334,11001,31.571428571428573,6.8364688803008535,"(37.5, 52.0]",Q3
36067,2020-05-01,461809,45,43,903,433,11434,34.142857142857146,7.393285350189612,"(37.5, 52.0]",Q3
36067,2020-05-02,461809,45,49,952,593,12027,37.142857142857146,8.042904565059828,"(37.5, 52.0]",Q3
36067,2020-05-03,461809,45,19,971,436,12463,35.0,7.578890840152531,"(37.5, 52.0]",Q3
36067,2020-05-04,461809,45,31,1002,176,12639,37.142857142857146,8.042904565059828,"(37.5, 52.0]",Q3
36067,2020-05-05,461809,45,54,1056,731,13370,39.142857142857146,8.475984041639974,"(37.5, 52.0]",Q3
36067,2020-05-06,461809,45,59,1115,534,13904,40.42857142857143,8.754392276584353,"(37.5, 52.0]",Q3
36067,2020-05-07,461809,45,54,1169,407,14311,44.142857142857146,9.558682733090334,"(37.5, 52.0]",Q3
36067,2020-05-08,461809,45,49,1218,464,14775,45.0,9.744288223053253,"(37.5, 52.0]",Q3
36067,2020-05-09,461809,45,47,1265,507,15282,44.714285714285715,9.682419726398948,"(37.5, 52.0]",Q3
36067,2020-05-10,461809,45,22,1287,240,15522,45.142857142857146,9.775222471380408,"(37.5, 52.0]",Q3
36067,2020-05-11,461809,45,21,1308,329,15851,43.714285714285715,9.465879988108874,"(37.5, 52.0]",Q3
36067,2020-05-12,461809,45,87,1395,1066,16917,48.42857142857143,10.48671018290493,"(37.5, 52.0]",Q3
36067,2020-05-13,461809,45,28,1423,683,17600,44.0,9.527748484763181,"(37.5, 52.0]",Q3
36067,2020-05-14,461809,45,17,1440,385,17985,38.714285714285715,8.383181296658513,"(37.5, 52.0]",Q3
36067,2020-05-15,461809,45,29,1469,1088,19073,35.857142857142854,7.764496330115449,"(37.5, 52.0]",Q3
36067,2020-05-16,461809,45,32,1501,648,19721,33.714285714285715,7.300482605208153,"(37.5, 52.0]",Q3
36067,2020-05-17,461809,45,19,1520,483,20204,33.285714285714285,7.207679860226692,"(37.5, 52.0]",Q3
36067,2020-05-18,461809,45,145,1665,1578,21782,51.0,11.043526652793688,"(37.5, 52.0]",Q3
36067,2020-05-19,461809,45,53,1718,1844,23626,46.142857142857146,9.99176220967048,"(37.5, 52.0]",Q3
36067,2020-05-20,461809,45,53,1771,1137,24763,49.714285714285715,10.765118417849308,"(37.5, 52.0]",Q3
36067,2020-05-21,461809,45,57,1828,1344,26107,55.42857142857143,12.002488350935437,"(37.5, 52.0]",Q3
36067,2020-05-22,461809,45,76,1904,2502,28609,62.142857142857146,13.456398022311635,"(37.5, 52.0]",Q3
36067,2020-05-23,461809,45,49,1953,1352,29961,64.57142857142857,13.982280243873241,"(37.5, 52.0]",Q3
36067,2020-05-24,461809,45,28,1981,1175,31136,65.85714285714286,14.260688478817618,"(37.5, 52.0]",Q3
36067,2020-05-25,461809,45,31,2012,1129,32265,49.57142857142857,10.734184169522155,"(37.5, 52.0]",Q3
36067,2020-05-26,461809,45,21,2033,676,32941,45.0,9.744288223053253,"(37.5, 52.0]",Q3
36067,2020-05-27,461809,45,21,2054,817,33758,40.42857142857143,8.754392276584353,"(37.5, 52.0]",Q3
36067,2020-05-28,461809,45,38,2092,1731,35489,37.714285714285715,8.166641558368442,"(37.5, 52.0]",Q3
36067,2020-05-29,461809,45,41,2133,2101,37590,32.714285714285715,7.08394286691808,"(37.5, 52.0]",Q3
36067,2020-05-30,461809,45,37,2170,1829,39419,31.0,6.712731886992242,"(37.5, 52.0]",Q3
36067,2020-05-31,461809,45,27,2197,1074,40493,30.857142857142858,6.681797638665088,"(37.5, 52.0]",Q3
36067,2020-06-01,461809,45,31,2228,1035,41528,30.857142857142858,6.681797638665088,"(37.5, 52.0]",Q3
36067,2020-06-02,461809,45,28,2256,1522,43050,31.857142857142858,6.89833737695516,"(37.5, 52.0]",Q3
36067,2020-06-03,461809,45,39,2295,2189,45239,34.42857142857143,7.455153846843919,"(37.5, 52.0]",Q3
36067,2020-06-04,461809,45,34,2329,1601,46840,33.857142857142854,7.331416853535305,"(37.5, 52.0]",Q3
36067,2020-06-05,461809,45,46,2375,2186,49026,34.57142857142857,7.486088095171071,"(37.5, 52.0]",Q3
36067,2020-06-06,461809,45,17,2392,1345,50371,31.714285714285715,6.867403128628007,"(37.5, 52.0]",Q3
36067,2020-06-07,461809,45,16,2408,2040,52411,30.142857142857142,6.527126397029322,"(37.5, 52.0]",Q3
36069,2020-03-02,109864,17,0,0,0,0,0.0,0.0,"(3.999, 24.0]",Q1
36069,2020-03-03,109864,17,0,0,0,0,0.0,0.0,"(3.999, 24.0]",Q1
36069,2020-03-04,109864,17,0,0,0,0,0.0,0.0,"(3.999, 24.0]",Q1
36069,2020-03-05,109864,17,0,0,0,0,0.0,0.0,"(3.999, 24.0]",Q1
36069,2020-03-06,109864,17,0,0,0,0,0.0,0.0,"(3.999, 24.0]",Q1
36069,2020-03-07,109864,17,0,0,0,0,0.0,0.0,"(3.999, 24.0]",Q1
36069,2020-03-08,109864,17,0,0,0,0,0.0,0.0,"(3.999, 24.0]",Q1
36069,2020-03-09,109864,17,0,0,0,0,0.0,0.0,"(3.999, 24.0]",Q1
36069,2020-03-10,109864,17,0,0,0,0,0.0,0.0,"(3.999, 24.0]",Q1
36069,2020-03-11,109864,17,0,0,0,0,0.0,0.0,"(3.999, 24.0]",Q1
36069,2020-03-12,109864,17,0,0,2,2,0.0,0.0,"(3.999, 24.0]",Q1
36069,2020-03-13,109864,17,0,0,4,6,0.0,0.0,"(3.999, 24.0]",Q1
36069,2020-03-14,109864,17,0,0,3,9,0.0,0.0,"(3.999, 24.0]",Q1
36069,2020-03-15,109864,17,1,1,5,14,0.14285714285714285,0.13003089534073295,"(3.999, 24.0]",Q1
36069,2020-03-16,109864,17,0,1,1,15,0.14285714285714285,0.13003089534073295,"(3.999, 24.0]",Q1
36069,2020-03-17,109864,17,0,1,3,18,0.14285714285714285,0.13003089534073295,"(3.999, 24.0]",Q1
36069,2020-03-18,109864,17,0,1,8,26,0.14285714285714285,0.13003089534073295,"(3.999, 24.0]",Q1
36069,2020-03-19,109864,17,2,3,15,41,0.42857142857142855,0.3900926860221989,"(3.999, 24.0]",Q1
36069,2020-03-20,109864,17,1,4,25,66,0.5714285714285714,0.5201235813629318,"(3.999, 24.0]",Q1
36069,2020-03-21,109864,17,2,6,25,91,0.8571428571428571,0.7801853720443978,"(3.999, 24.0]",Q1
36069,2020-03-22,109864,17,0,6,5,96,0.7142857142857143,0.6501544767036649,"(3.999, 24.0]",Q1
36069,2020-03-23,109864,17,1,7,13,109,0.8571428571428571,0.7801853720443978,"(3.999, 24.0]",Q1
36069,2020-03-24,109864,17,2,9,19,128,1.1428571428571428,1.0402471627258636,"(3.999, 24.0]",Q1
36069,2020-03-25,109864,17,2,11,21,149,1.4285714285714286,1.3003089534073298,"(3.999, 24.0]",Q1
36069,2020-03-26,109864,17,3,14,29,178,1.5714285714285714,1.4303398487480625,"(3.999, 24.0]",Q1
36069,2020-03-27,109864,17,2,16,34,212,1.7142857142857142,1.5603707440887955,"(3.999, 24.0]",Q1
36069,2020-03-28,109864,17,2,18,26,238,1.7142857142857142,1.5603707440887955,"(3.999, 24.0]",Q1
36069,2020-03-29,109864,17,2,20,16,254,2.0,1.8204325347702612,"(3.999, 24.0]",Q1
36069,2020-03-30,109864,17,2,22,26,280,2.142857142857143,1.9504634301109942,"(3.999, 24.0]",Q1
36069,2020-03-31,109864,17,2,24,37,317,2.142857142857143,1.9504634301109942,"(3.999, 24.0]",Q1
36069,2020-04-01,109864,17,2,26,29,346,2.142857142857143,1.9504634301109942,"(3.999, 24.0]",Q1
36069,2020-04-02,109864,17,2,28,29,375,2.0,1.8204325347702612,"(3.999, 24.0]",Q1
36069,2020-04-03,109864,17,3,31,36,411,2.142857142857143,1.9504634301109942,"(3.999, 24.0]",Q1
36069,2020-04-04,109864,17,1,32,33,444,2.0,1.8204325347702612,"(3.999, 24.0]",Q1
36069,2020-04-05,109864,17,0,32,26,470,1.7142857142857142,1.5603707440887955,"(3.999, 24.0]",Q1
36069,2020-04-06,109864,17,1,33,32,502,1.5714285714285714,1.4303398487480625,"(3.999, 24.0]",Q1
36069,2020-04-07,109864,17,6,39,50,552,2.142857142857143,1.9504634301109942,"(3.999, 24.0]",Q1
36069,2020-04-08,109864,17,4,43,38,590,2.4285714285714284,2.21052522079246,"(3.999, 24.0]",Q1
36069,2020-04-09,109864,17,8,51,50,640,3.2857142857142856,2.990710592836858,"(3.999, 24.0]",Q1
36069,2020-04-10,109864,17,5,56,39,679,3.5714285714285716,3.2507723835183246,"(3.999, 24.0]",Q1
36069,2020-04-11,109864,17,1,57,27,706,3.5714285714285716,3.2507723835183246,"(3.999, 24.0]",Q1
36069,2020-04-12,109864,17,0,57,12,718,3.5714285714285716,3.2507723835183246,"(3.999, 24.0]",Q1
36069,2020-04-13,109864,17,4,61,48,766,4.0,3.6408650695405225,"(3.999, 24.0]",Q1
36069,2020-04-14,109864,17,1,62,25,791,3.2857142857142856,2.990710592836858,"(3.999, 24.0]",Q1
36069,2020-04-15,109864,17,3,65,31,822,3.142857142857143,2.860679697496125,"(3.999, 24.0]",Q1
36069,2020-04-16,109864,17,2,67,34,856,2.2857142857142856,2.080494325451727,"(3.999, 24.0]",Q1
36069,2020-04-17,109864,17,2,69,33,889,1.8571428571428572,1.6904016394295283,"(3.999, 24.0]",Q1
36069,2020-04-18,109864,17,1,70,24,913,1.8571428571428572,1.6904016394295283,"(3.999, 24.0]",Q1
36069,2020-04-19,109864,17,1,71,20,933,2.0,1.8204325347702612,"(3.999, 24.0]",Q1
36069,2020-04-20,109864,17,1,72,43,976,1.5714285714285714,1.4303398487480625,"(3.999, 24.0]",Q1
36069,2020-04-21,109864,17,1,73,66,1042,1.5714285714285714,1.4303398487480625,"(3.999, 24.0]",Q1
36069,2020-04-22,109864,17,0,73,31,1073,1.1428571428571428,1.0402471627258636,"(3.999, 24.0]",Q1
36069,2020-04-23,109864,17,0,73,37,1110,0.8571428571428571,0.7801853720443978,"(3.999, 24.0]",Q1
36069,2020-04-24,109864,17,9,82,239,1349,1.8571428571428572,1.6904016394295283,"(3.999, 24.0]",Q1
36069,2020-04-25,109864,17,2,84,34,1383,2.0,1.8204325347702612,"(3.999, 24.0]",Q1
36069,2020-04-26,109864,17,2,86,40,1423,2.142857142857143,1.9504634301109942,"(3.999, 24.0]",Q1
36069,2020-04-27,109864,17,4,90,50,1473,2.5714285714285716,2.3405561161331936,"(3.999, 24.0]",Q1
36069,2020-04-28,109864,17,0,90,60,1533,2.4285714285714284,2.21052522079246,"(3.999, 24.0]",Q1
36069,2020-04-29,109864,17,0,90,78,1611,2.4285714285714284,2.21052522079246,"(3.999, 24.0]",Q1
36069,2020-04-30,109864,17,1,91,91,1702,2.5714285714285716,2.3405561161331936,"(3.999, 24.0]",Q1
36069,2020-05-01,109864,17,1,92,62,1764,1.4285714285714286,1.3003089534073298,"(3.999, 24.0]",Q1
36069,2020-05-02,109864,17,3,95,90,1854,1.5714285714285714,1.4303398487480625,"(3.999, 24.0]",Q1
36069,2020-05-03,109864,17,1,96,81,1935,1.4285714285714286,1.3003089534073298,"(3.999, 24.0]",Q1
36069,2020-05-04,109864,17,1,97,86,2021,1.0,0.9102162673851306,"(3.999, 24.0]",Q1
36069,2020-05-05,109864,17,2,99,105,2126,1.2857142857142858,1.1702780580665968,"(3.999, 24.0]",Q1
36069,2020-05-06,109864,17,2,101,121,2247,1.5714285714285714,1.4303398487480625,"(3.999, 24.0]",Q1
36069,2020-05-07,109864,17,3,104,108,2355,1.8571428571428572,1.6904016394295283,"(3.999, 24.0]",Q1
36069,2020-05-08,109864,17,0,104,69,2424,1.7142857142857142,1.5603707440887955,"(3.999, 24.0]",Q1
36069,2020-05-09,109864,17,2,106,109,2533,1.5714285714285714,1.4303398487480625,"(3.999, 24.0]",Q1
36069,2020-05-10,109864,17,1,107,92,2625,1.5714285714285714,1.4303398487480625,"(3.999, 24.0]",Q1
36069,2020-05-11,109864,17,0,107,74,2699,1.4285714285714286,1.3003089534073298,"(3.999, 24.0]",Q1
36069,2020-05-12,109864,17,2,109,140,2839,1.4285714285714286,1.3003089534073298,"(3.999, 24.0]",Q1
36069,2020-05-13,109864,17,20,129,334,3173,4.0,3.6408650695405225,"(3.999, 24.0]",Q1
36069,2020-05-14,109864,17,4,133,135,3308,4.142857142857143,3.770895964881256,"(3.999, 24.0]",Q1
36069,2020-05-15,109864,17,6,139,136,3444,5.0,4.5510813369256535,"(3.999, 24.0]",Q1
36069,2020-05-16,109864,17,7,146,160,3604,5.714285714285714,5.201235813629319,"(3.999, 24.0]",Q1
36069,2020-05-17,109864,17,2,148,96,3700,5.857142857142857,5.331266708970051,"(3.999, 24.0]",Q1
36069,2020-05-18,109864,17,4,152,157,3857,6.428571428571429,5.851390290332984,"(3.999, 24.0]",Q1
36069,2020-05-19,109864,17,18,170,351,4208,8.714285714285714,7.93188461578471,"(3.999, 24.0]",Q1
36069,2020-05-20,109864,17,6,176,264,4472,6.714285714285714,6.111452081014449,"(3.999, 24.0]",Q1
36069,2020-05-21,109864,17,4,180,191,4663,6.714285714285714,6.111452081014449,"(3.999, 24.0]",Q1
36069,2020-05-22,109864,17,2,182,125,4788,6.142857142857143,5.591328499651517,"(3.999, 24.0]",Q1
36069,2020-05-23,109864,17,2,184,201,4989,5.428571428571429,4.941174022947853,"(3.999, 24.0]",Q1
36069,2020-05-24,109864,17,1,185,99,5088,5.285714285714286,4.811143127607119,"(3.999, 24.0]",Q1
36069,2020-05-25,109864,17,10,195,218,5306,6.142857142857143,5.591328499651517,"(3.999, 24.0]",Q1
36069,2020-05-26,109864,17,3,198,182,5488,4.0,3.6408650695405225,"(3.999, 24.0]",Q1
36069,2020-05-27,109864,17,3,201,246,5734,3.5714285714285716,3.2507723835183246,"(3.999, 24.0]",Q1
36069,2020-05-28,109864,17,4,205,209,5943,3.5714285714285716,3.2507723835183246,"(3.999, 24.0]",Q1
36069,2020-05-29,109864,17,1,206,126,6069,3.4285714285714284,3.120741488177591,"(3.999, 24.0]",Q1
36069,2020-05-30,109864,17,1,207,328,6397,3.2857142857142856,2.990710592836858,"(3.999, 24.0]",Q1
36069,2020-05-31,109864,17,1,208,188,6585,3.2857142857142856,2.990710592836858,"(3.999, 24.0]",Q1
36069,2020-06-01,109864,17,1,209,206,6791,2.0,1.8204325347702612,"(3.999, 24.0]",Q1
36069,2020-06-02,109864,17,6,215,485,7276,2.4285714285714284,2.21052522079246,"(3.999, 24.0]",Q1
36069,2020-06-03,109864,17,3,218,421,7697,2.4285714285714284,2.21052522079246,"(3.999, 24.0]",Q1
36069,2020-06-04,109864,17,1,219,379,8076,2.0,1.8204325347702612,"(3.999, 24.0]",Q1
36069,2020-06-05,109864,17,1,220,505,8581,2.0,1.8204325347702612,"(3.999, 24.0]",Q1
36069,2020-06-06,109864,17,1,221,236,8817,2.0,1.8204325347702612,"(3.999, 24.0]",Q1
36069,2020-06-07,109864,17,0,221,293,9110,1.8571428571428572,1.6904016394295283,"(3.999, 24.0]",Q1
36071,2020-03-02,381951,36,0,0,0,0,0.0,0.0,"(24.0, 37.5]",Q2
36071,2020-03-03,381951,36,0,0,0,0,0.0,0.0,"(24.0, 37.5]",Q2
36071,2020-03-04,381951,36,0,0,0,0,0.0,0.0,"(24.0, 37.5]",Q2
36071,2020-03-05,381951,36,0,0,0,0,0.0,0.0,"(24.0, 37.5]",Q2
36071,2020-03-06,381951,36,0,0,0,0,0.0,0.0,"(24.0, 37.5]",Q2
36071,2020-03-07,381951,36,0,0,0,0,0.0,0.0,"(24.0, 37.5]",Q2
36071,2020-03-08,381951,36,0,0,0,0,0.0,0.0,"(24.0, 37.5]",Q2
36071,2020-03-09,381951,36,0,0,1,1,0.0,0.0,"(24.0, 37.5]",Q2
36071,2020-03-10,381951,36,0,0,0,1,0.0,0.0,"(24.0, 37.5]",Q2
36071,2020-03-11,381951,36,1,1,4,5,0.14285714285714285,0.03740195544903478,"(24.0, 37.5]",Q2
36071,2020-03-12,381951,36,0,1,12,17,0.14285714285714285,0.03740195544903478,"(24.0, 37.5]",Q2
36071,2020-03-13,381951,36,5,6,22,39,0.8571428571428571,0.22441173269420872,"(24.0, 37.5]",Q2
36071,2020-03-14,381951,36,0,6,12,51,0.8571428571428571,0.22441173269420872,"(24.0, 37.5]",Q2
36071,2020-03-15,381951,36,5,11,36,87,1.5714285714285714,0.41142150993938265,"(24.0, 37.5]",Q2
36071,2020-03-16,381951,36,4,15,36,123,2.142857142857143,0.5610293317355218,"(24.0, 37.5]",Q2
36071,2020-03-17,381951,36,17,32,83,206,4.571428571428571,1.196862574369113,"(24.0, 37.5]",Q2
36071,2020-03-18,381951,36,19,51,94,300,7.142857142857143,1.8700977724517394,"(24.0, 37.5]",Q2
36071,2020-03-19,381951,36,33,84,180,480,11.857142857142858,3.1043623022698874,"(24.0, 37.5]",Q2
36071,2020-03-20,381951,36,79,163,377,857,22.428571428571427,5.872107005498461,"(24.0, 37.5]",Q2
36071,2020-03-21,381951,36,84,247,393,1250,34.42857142857143,9.013871263217384,"(24.0, 37.5]",Q2
36071,2020-03-22,381951,36,142,389,472,1722,54.0,14.137939159735149,"(24.0, 37.5]",Q2
36071,2020-03-23,381951,36,109,498,340,2062,69.0,18.065144481883802,"(24.0, 37.5]",Q2
36071,2020-03-24,381951,36,140,638,298,2360,86.57142857142857,22.66558500211508,"(24.0, 37.5]",Q2
36071,2020-03-25,381951,36,113,751,322,2682,100.0,26.18136881432435,"(24.0, 37.5]",Q2
36071,2020-03-26,381951,36,160,911,394,3076,118.14285714285714,30.931417156351767,"(24.0, 37.5]",Q2
36071,2020-03-27,381951,36,190,1101,498,3574,134.0,35.08303421119463,"(24.0, 37.5]",Q2
36071,2020-03-28,381951,36,146,1247,373,3947,142.85714285714286,37.40195544903479,"(24.0, 37.5]",Q2
36071,2020-03-29,381951,36,188,1435,394,4341,149.42857142857142,39.122445399690385,"(24.0, 37.5]",Q2
36071,2020-03-30,381951,36,121,1556,306,4647,151.14285714285714,39.5712688650788,"(24.0, 37.5]",Q2
36071,2020-03-31,381951,36,200,1756,477,5124,159.71428571428572,41.81538619202089,"(24.0, 37.5]",Q2
36071,2020-04-01,381951,36,237,1993,628,5752,177.42857142857142,46.453228667701204,"(24.0, 37.5]",Q2
36071,2020-04-02,381951,36,404,2397,1114,6866,212.28571428571428,55.57930579726569,"(24.0, 37.5]",Q2
36071,2020-04-03,381951,36,344,2741,1046,7912,234.28571428571428,61.33920693641705,"(24.0, 37.5]",Q2
36071,2020-04-04,381951,36,361,3102,1077,8989,265.0,69.38062735795954,"(24.0, 37.5]",Q2
36071,2020-04-05,381951,36,295,3397,827,9816,280.2857142857143,73.38263659100625,"(24.0, 37.5]",Q2
36071,2020-04-06,381951,36,202,3599,604,10420,291.85714285714283,76.41219498237805,"(24.0, 37.5]",Q2
36071,2020-04-07,381951,36,266,3865,711,11131,301.2857142857143,78.88072404201436,"(24.0, 37.5]",Q2
36071,2020-04-08,381951,36,225,4090,578,11709,299.57142857142856,78.43190057662595,"(24.0, 37.5]",Q2
36071,2020-04-09,381951,36,442,4532,1335,13044,305.0,79.85317488368926,"(24.0, 37.5]",Q2
36071,2020-04-10,381951,36,315,4847,879,13923,300.85714285714283,78.76851817566725,"(24.0, 37.5]",Q2
36071,2020-04-11,381951,36,180,5027,563,14486,275.0,71.99876423939197,"(24.0, 37.5]",Q2
36071,2020-04-12,381951,36,155,5182,492,14978,255.0,66.76249047652709,"(24.0, 37.5]",Q2
36071,2020-04-13,381951,36,396,5578,1161,16139,282.7142857142857,74.01846983363984,"(24.0, 37.5]",Q2
36071,2020-04-14,381951,36,138,5716,341,16480,264.42857142857144,69.23101953616339,"(24.0, 37.5]",Q2
36071,2020-04-15,381951,36,172,5888,521,17001,256.85714285714283,67.24871589736453,"(24.0, 37.5]",Q2
36071,2020-04-16,381951,36,196,6084,512,17513,221.71428571428572,58.04783485690199,"(24.0, 37.5]",Q2
36071,2020-04-17,381951,36,182,6266,575,18088,202.71428571428572,53.073374782180366,"(24.0, 37.5]",Q2
36071,2020-04-18,381951,36,113,6379,411,18499,193.14285714285714,50.56744376709503,"(24.0, 37.5]",Q2
36071,2020-04-19,381951,36,103,6482,278,18777,185.71428571428572,48.62254208374522,"(24.0, 37.5]",Q2
36071,2020-04-20,381951,36,79,6561,298,19075,140.42857142857142,36.76612220640119,"(24.0, 37.5]",Q2
36071,2020-04-21,381951,36,129,6690,430,19505,139.14285714285714,36.42950460735988,"(24.0, 37.5]",Q2
36071,2020-04-22,381951,36,126,6816,399,19904,132.57142857142858,34.709014656704284,"(24.0, 37.5]",Q2
36071,2020-04-23,381951,36,339,7155,1213,21117,153.0,40.057494285916256,"(24.0, 37.5]",Q2
36071,2020-04-24,381951,36,818,7973,2748,23865,243.85714285714286,63.84513795150239,"(24.0, 37.5]",Q2
36071,2020-04-25,381951,36,133,8106,643,24508,246.71428571428572,64.59317706048309,"(24.0, 37.5]",Q2
36071,2020-04-26,381951,36,132,8238,587,25095,250.85714285714286,65.67783376850508,"(24.0, 37.5]",Q2
36071,2020-04-27,381951,36,136,8374,645,25740,259.0,67.80974522910007,"(24.0, 37.5]",Q2
36071,2020-04-28,381951,36,114,8488,602,26342,256.85714285714283,67.24871589736453,"(24.0, 37.5]",Q2
36071,2020-04-29,381951,36,162,8650,880,27222,262.0,68.59518629352979,"(24.0, 37.5]",Q2
36071,2020-04-30,381951,36,101,8751,787,28009,228.0,59.693520896659514,"(24.0, 37.5]",Q2
36071,2020-05-01,381951,36,159,8910,839,28848,133.85714285714286,35.045632255745595,"(24.0, 37.5]",Q2
36071,2020-05-02,381951,36,57,8967,510,29358,123.0,32.20308364161895,"(24.0, 37.5]",Q2
36071,2020-05-03,381951,36,48,9015,421,29779,111.0,29.06131938390003,"(24.0, 37.5]",Q2
36071,2020-05-04,381951,36,129,9144,869,30648,110.0,28.79950569575679,"(24.0, 37.5]",Q2
36071,2020-05-05,381951,36,71,9215,509,31157,103.85714285714286,27.191221611448288,"(24.0, 37.5]",Q2
36071,2020-05-06,381951,36,113,9328,1181,32338,96.85714285714286,25.358525794445587,"(24.0, 37.5]",Q2
36071,2020-05-07,381951,36,74,9402,842,33180,93.0,24.348672997321646,"(24.0, 37.5]",Q2
36071,2020-05-08,381951,36,84,9486,690,33870,82.28571428571429,21.54352633864404,"(24.0, 37.5]",Q2
36071,2020-05-09,381951,36,57,9543,535,34405,82.28571428571429,21.54352633864404,"(24.0, 37.5]",Q2
36071,2020-05-10,381951,36,41,9584,402,34807,81.28571428571429,21.281712650500797,"(24.0, 37.5]",Q2
36071,2020-05-11,381951,36,48,9632,516,35323,69.71428571428571,18.252154259128975,"(24.0, 37.5]",Q2
36071,2020-05-12,381951,36,61,9693,614,35937,68.28571428571429,17.87813470463863,"(24.0, 37.5]",Q2
36071,2020-05-13,381951,36,78,9771,939,36876,63.285714285714285,16.569066263922412,"(24.0, 37.5]",Q2
36071,2020-05-14,381951,36,54,9825,766,37642,60.42857142857143,15.821027154941714,"(24.0, 37.5]",Q2
36071,2020-05-15,381951,36,54,9879,715,38357,56.142857142857146,14.698968491470673,"(24.0, 37.5]",Q2
36071,2020-05-16,381951,36,64,9943,662,39019,57.142857142857146,14.960782179613915,"(24.0, 37.5]",Q2
36071,2020-05-17,381951,36,22,9965,367,39386,54.42857142857143,14.250145026082253,"(24.0, 37.5]",Q2
36071,2020-05-18,381951,36,23,9988,362,39748,50.857142857142854,13.315096139856383,"(24.0, 37.5]",Q2
36071,2020-05-19,381951,36,55,10043,819,40567,50.0,13.090684407162176,"(24.0, 37.5]",Q2
36071,2020-05-20,381951,36,49,10092,919,41486,45.857142857142854,12.006027699140166,"(24.0, 37.5]",Q2
36071,2020-05-21,381951,36,50,10142,753,42239,45.285714285714285,11.856419877344026,"(24.0, 37.5]",Q2
36071,2020-05-22,381951,36,55,10197,764,43003,45.42857142857143,11.893821832793062,"(24.0, 37.5]",Q2
36071,2020-05-23,381951,36,28,10225,638,43641,40.285714285714285,10.54735143662781,"(24.0, 37.5]",Q2
36071,2020-05-24,381951,36,19,10244,478,44119,39.857142857142854,10.435145570280705,"(24.0, 37.5]",Q2
36071,2020-05-25,381951,36,33,10277,617,44736,41.285714285714285,10.809165124771054,"(24.0, 37.5]",Q2
36071,2020-05-26,381951,36,15,10292,528,45264,35.57142857142857,9.313086906809662,"(24.0, 37.5]",Q2
36071,2020-05-27,381951,36,33,10325,1013,46277,33.285714285714285,8.714655619625105,"(24.0, 37.5]",Q2
36071,2020-05-28,381951,36,36,10361,868,47145,31.285714285714285,8.191028243338618,"(24.0, 37.5]",Q2
36071,2020-05-29,381951,36,28,10389,776,47921,27.428571428571427,7.181175446214679,"(24.0, 37.5]",Q2
36071,2020-05-30,381951,36,17,10406,683,48604,25.857142857142858,6.769753936275296,"(24.0, 37.5]",Q2
36071,2020-05-31,381951,36,16,10422,713,49317,25.428571428571427,6.6575480699281915,"(24.0, 37.5]",Q2
36071,2020-06-01,381951,36,27,10449,1027,50344,24.571428571428573,6.433136337233983,"(24.0, 37.5]",Q2
36071,2020-06-02,381951,36,11,10460,842,51186,24.0,6.283528515437844,"(24.0, 37.5]",Q2
36071,2020-06-03,381951,36,11,10471,941,52127,20.857142857142858,5.460685495559079,"(24.0, 37.5]",Q2
36071,2020-06-04,381951,36,13,10484,978,53105,17.571428571428573,4.600440520231279,"(24.0, 37.5]",Q2
36071,2020-06-05,381951,36,24,10508,1157,54262,17.0,4.450832698435139,"(24.0, 37.5]",Q2
36071,2020-06-06,381951,36,6,10514,847,55109,15.428571428571429,4.039411188495757,"(24.0, 37.5]",Q2
36071,2020-06-07,381951,36,9,10523,827,55936,14.428571428571429,3.7775975003525137,"(24.0, 37.5]",Q2
36073,2020-03-02,40612,50,0,0,0,0,0.0,0.0,"(37.5, 52.0]",Q3
36073,2020-03-03,40612,50,0,0,0,0,0.0,0.0,"(37.5, 52.0]",Q3
36073,2020-03-04,40612,50,0,0,0,0,0.0,0.0,"(37.5, 52.0]",Q3
36073,2020-03-05,40612,50,0,0,0,0,0.0,0.0,"(37.5, 52.0]",Q3
36073,2020-03-06,40612,50,0,0,0,0,0.0,0.0,"(37.5, 52.0]",Q3
36073,2020-03-07,40612,50,0,0,0,0,0.0,0.0,"(37.5, 52.0]",Q3
36073,2020-03-08,40612,50,0,0,0,0,0.0,0.0,"(37.5, 52.0]",Q3
36073,2020-03-09,40612,50,0,0,0,0,0.0,0.0,"(37.5, 52.0]",Q3
36073,2020-03-10,40612,50,0,0,0,0,0.0,0.0,"(37.5, 52.0]",Q3
36073,2020-03-11,40612,50,0,0,0,0,0.0,0.0,"(37.5, 52.0]",Q3
36073,2020-03-12,40612,50,0,0,0,0,0.0,0.0,"(37.5, 52.0]",Q3
36073,2020-03-13,40612,50,0,0,1,1,0.0,0.0,"(37.5, 52.0]",Q3
36073,2020-03-14,40612,50,0,0,0,1,0.0,0.0,"(37.5, 52.0]",Q3
36073,2020-03-15,40612,50,0,0,0,1,0.0,0.0,"(37.5, 52.0]",Q3
36073,2020-03-16,40612,50,0,0,5,6,0.0,0.0,"(37.5, 52.0]",Q3
36073,2020-03-17,40612,50,0,0,5,11,0.0,0.0,"(37.5, 52.0]",Q3
36073,2020-03-18,40612,50,0,0,3,14,0.0,0.0,"(37.5, 52.0]",Q3
36073,2020-03-19,40612,50,0,0,6,20,0.0,0.0,"(37.5, 52.0]",Q3
36073,2020-03-20,40612,50,0,0,5,25,0.0,0.0,"(37.5, 52.0]",Q3
36073,2020-03-21,40612,50,0,0,7,32,0.0,0.0,"(37.5, 52.0]",Q3
36073,2020-03-22,40612,50,0,0,4,36,0.0,0.0,"(37.5, 52.0]",Q3
36073,2020-03-23,40612,50,2,2,9,45,0.2857142857142857,0.7035218302823937,"(37.5, 52.0]",Q3
36073,2020-03-24,40612,50,0,2,7,52,0.2857142857142857,0.7035218302823937,"(37.5, 52.0]",Q3
36073,2020-03-25,40612,50,0,2,11,63,0.2857142857142857,0.7035218302823937,"(37.5, 52.0]",Q3
36073,2020-03-26,40612,50,1,3,11,74,0.42857142857142855,1.0552827454235905,"(37.5, 52.0]",Q3
36073,2020-03-27,40612,50,0,3,8,82,0.42857142857142855,1.0552827454235905,"(37.5, 52.0]",Q3
36073,2020-03-28,40612,50,0,3,3,85,0.42857142857142855,1.0552827454235905,"(37.5, 52.0]",Q3
36073,2020-03-29,40612,50,1,4,11,96,0.5714285714285714,1.4070436605647874,"(37.5, 52.0]",Q3
36073,2020-03-30,40612,50,2,6,14,110,0.5714285714285714,1.4070436605647874,"(37.5, 52.0]",Q3
36073,2020-03-31,40612,50,0,6,6,116,0.5714285714285714,1.4070436605647874,"(37.5, 52.0]",Q3
36073,2020-04-01,40612,50,0,6,11,127,0.5714285714285714,1.4070436605647874,"(37.5, 52.0]",Q3
36073,2020-04-02,40612,50,3,9,13,140,0.8571428571428571,2.110565490847181,"(37.5, 52.0]",Q3
36073,2020-04-03,40612,50,1,10,11,151,1.0,2.462326405988378,"(37.5, 52.0]",Q3
36073,2020-04-04,40612,50,1,11,9,160,1.1428571428571428,2.8140873211295747,"(37.5, 52.0]",Q3
36073,2020-04-05,40612,50,2,13,16,176,1.2857142857142858,3.165848236270772,"(37.5, 52.0]",Q3
36073,2020-04-06,40612,50,2,15,17,193,1.2857142857142858,3.165848236270772,"(37.5, 52.0]",Q3
36073,2020-04-07,40612,50,1,16,14,207,1.4285714285714286,3.5176091514119685,"(37.5, 52.0]",Q3
36073,2020-04-08,40612,50,6,22,27,234,2.2857142857142856,5.628174642259149,"(37.5, 52.0]",Q3
36073,2020-04-09,40612,50,2,24,14,248,2.142857142857143,5.276413727117952,"(37.5, 52.0]",Q3
36073,2020-04-10,40612,50,0,24,3,251,2.0,4.924652811976756,"(37.5, 52.0]",Q3
36073,2020-04-11,40612,50,1,25,7,258,2.0,4.924652811976756,"(37.5, 52.0]",Q3
36073,2020-04-12,40612,50,1,26,6,264,1.8571428571428572,4.572891896835559,"(37.5, 52.0]",Q3
36073,2020-04-13,40612,50,5,31,18,282,2.2857142857142856,5.628174642259149,"(37.5, 52.0]",Q3
36073,2020-04-14,40612,50,2,33,8,290,2.4285714285714284,5.979935557400346,"(37.5, 52.0]",Q3
36073,2020-04-15,40612,50,1,34,5,295,1.7142857142857142,4.221130981694362,"(37.5, 52.0]",Q3
36073,2020-04-16,40612,50,0,34,4,299,1.4285714285714286,3.5176091514119685,"(37.5, 52.0]",Q3
36073,2020-04-17,40612,50,7,41,14,313,2.4285714285714284,5.979935557400346,"(37.5, 52.0]",Q3
36073,2020-04-18,40612,50,5,46,35,348,3.0,7.386979217965134,"(37.5, 52.0]",Q3
36073,2020-04-19,40612,50,0,46,3,351,2.857142857142857,7.035218302823937,"(37.5, 52.0]",Q3
36073,2020-04-20,40612,50,7,53,33,384,3.142857142857143,7.7387401331063295,"(37.5, 52.0]",Q3
36073,2020-04-21,40612,50,3,56,11,395,3.2857142857142856,8.090501048247527,"(37.5, 52.0]",Q3
36073,2020-04-22,40612,50,3,59,11,406,3.5714285714285716,8.79402287852992,"(37.5, 52.0]",Q3
36073,2020-04-23,40612,50,1,60,13,419,3.7142857142857144,9.145783793671118,"(37.5, 52.0]",Q3
36073,2020-04-24,40612,50,15,75,98,517,4.857142857142857,11.959871114800691,"(37.5, 52.0]",Q3
36073,2020-04-25,40612,50,5,80,28,545,4.857142857142857,11.959871114800691,"(37.5, 52.0]",Q3
36073,2020-04-26,40612,50,0,80,14,559,4.857142857142857,11.959871114800691,"(37.5, 52.0]",Q3
36073,2020-04-27,40612,50,0,80,8,567,3.857142857142857,9.497544708812315,"(37.5, 52.0]",Q3
36073,2020-04-28,40612,50,5,85,26,593,4.142857142857143,10.20106653909471,"(37.5, 52.0]",Q3
36073,2020-04-29,40612,50,4,89,35,628,4.285714285714286,10.552827454235905,"(37.5, 52.0]",Q3
36073,2020-04-30,40612,50,3,92,23,651,4.571428571428571,11.256349284518299,"(37.5, 52.0]",Q3
36073,2020-05-01,40612,50,1,93,29,680,2.5714285714285716,6.331696472541544,"(37.5, 52.0]",Q3
36073,2020-05-02,40612,50,4,97,22,702,2.4285714285714284,5.979935557400346,"(37.5, 52.0]",Q3
36073,2020-05-03,40612,50,0,97,21,723,2.4285714285714284,5.979935557400346,"(37.5, 52.0]",Q3
36073,2020-05-04,40612,50,2,99,15,738,2.7142857142857144,6.68345738768274,"(37.5, 52.0]",Q3
36073,2020-05-05,40612,50,4,103,36,774,2.5714285714285716,6.331696472541544,"(37.5, 52.0]",Q3
36073,2020-05-06,40612,50,5,108,33,807,2.7142857142857144,6.68345738768274,"(37.5, 52.0]",Q3
36073,2020-05-07,40612,50,13,121,62,869,4.142857142857143,10.20106653909471,"(37.5, 52.0]",Q3
36073,2020-05-08,40612,50,1,122,29,898,4.142857142857143,10.20106653909471,"(37.5, 52.0]",Q3
36073,2020-05-09,40612,50,4,126,41,939,4.142857142857143,10.20106653909471,"(37.5, 52.0]",Q3
36073,2020-05-10,40612,50,4,130,40,979,4.714285714285714,11.608110199659496,"(37.5, 52.0]",Q3
36073,2020-05-11,40612,50,3,133,31,1010,4.857142857142857,11.959871114800691,"(37.5, 52.0]",Q3
36073,2020-05-12,40612,50,9,142,61,1071,5.571428571428571,13.718675690506675,"(37.5, 52.0]",Q3
36073,2020-05-13,40612,50,3,145,57,1128,5.285714285714286,13.015153860224284,"(37.5, 52.0]",Q3
36073,2020-05-14,40612,50,2,147,38,1166,3.7142857142857144,9.145783793671118,"(37.5, 52.0]",Q3
36073,2020-05-15,40612,50,16,163,102,1268,5.857142857142857,14.42219752078907,"(37.5, 52.0]",Q3
36073,2020-05-16,40612,50,4,167,59,1327,5.857142857142857,14.42219752078907,"(37.5, 52.0]",Q3
36073,2020-05-17,40612,50,0,167,42,1369,5.285714285714286,13.015153860224284,"(37.5, 52.0]",Q3
36073,2020-05-18,40612,50,1,168,48,1417,5.0,12.31163202994189,"(37.5, 52.0]",Q3
36073,2020-05-19,40612,50,3,171,60,1477,4.142857142857143,10.20106653909471,"(37.5, 52.0]",Q3
36073,2020-05-20,40612,50,3,174,98,1575,4.142857142857143,10.20106653909471,"(37.5, 52.0]",Q3
36073,2020-05-21,40612,50,1,175,50,1625,4.0,9.849305623953512,"(37.5, 52.0]",Q3
36073,2020-05-22,40612,50,21,196,85,1710,4.714285714285714,11.608110199659496,"(37.5, 52.0]",Q3
36073,2020-05-23,40612,50,6,202,129,1839,5.0,12.31163202994189,"(37.5, 52.0]",Q3
36073,2020-05-24,40612,50,3,205,63,1902,5.428571428571429,13.36691477536548,"(37.5, 52.0]",Q3
36073,2020-05-25,40612,50,3,208,49,1951,5.714285714285714,14.070436605647874,"(37.5, 52.0]",Q3
36073,2020-05-26,40612,50,2,210,44,1995,5.571428571428571,13.718675690506675,"(37.5, 52.0]",Q3
36073,2020-05-27,40612,50,2,212,117,2112,5.428571428571429,13.36691477536548,"(37.5, 52.0]",Q3
36073,2020-05-28,40612,50,4,216,112,2224,5.857142857142857,14.42219752078907,"(37.5, 52.0]",Q3
36073,2020-05-29,40612,50,12,228,83,2307,4.571428571428571,11.256349284518299,"(37.5, 52.0]",Q3
36073,2020-05-30,40612,50,1,229,101,2408,3.857142857142857,9.497544708812315,"(37.5, 52.0]",Q3
36073,2020-05-31,40612,50,7,236,105,2513,4.428571428571429,10.904588369377104,"(37.5, 52.0]",Q3
36073,2020-06-01,40612,50,5,241,89,2602,4.714285714285714,11.608110199659496,"(37.5, 52.0]",Q3
36073,2020-06-02,40612,50,5,246,157,2759,5.142857142857143,12.663392945083087,"(37.5, 52.0]",Q3
36073,2020-06-03,40612,50,1,247,81,2840,5.0,12.31163202994189,"(37.5, 52.0]",Q3
36073,2020-06-04,40612,50,0,247,102,2942,4.428571428571429,10.904588369377104,"(37.5, 52.0]",Q3
36073,2020-06-05,40612,50,7,254,183,3125,3.7142857142857144,9.145783793671118,"(37.5, 52.0]",Q3
36073,2020-06-06,40612,50,1,255,115,3240,3.7142857142857144,9.145783793671118,"(37.5, 52.0]",Q3
36073,2020-06-07,40612,50,1,256,69,3309,2.857142857142857,7.035218302823937,"(37.5, 52.0]",Q3
36075,2020-03-02,117898,62,0,0,0,0,0.0,0.0,"(52.0, 100.0]",Q4
36075,2020-03-03,117898,62,0,0,0,0,0.0,0.0,"(52.0, 100.0]",Q4
36075,2020-03-04,117898,62,0,0,0,0,0.0,0.0,"(52.0, 100.0]",Q4
36075,2020-03-05,117898,62,0,0,0,0,0.0,0.0,"(52.0, 100.0]",Q4
36075,2020-03-06,117898,62,0,0,0,0,0.0,0.0,"(52.0, 100.0]",Q4
36075,2020-03-07,117898,62,0,0,0,0,0.0,0.0,"(52.0, 100.0]",Q4
36075,2020-03-08,117898,62,0,0,0,0,0.0,0.0,"(52.0, 100.0]",Q4
36075,2020-03-09,117898,62,0,0,0,0,0.0,0.0,"(52.0, 100.0]",Q4
36075,2020-03-10,117898,62,0,0,1,1,0.0,0.0,"(52.0, 100.0]",Q4
36075,2020-03-11,117898,62,0,0,0,1,0.0,0.0,"(52.0, 100.0]",Q4
36075,2020-03-12,117898,62,0,0,0,1,0.0,0.0,"(52.0, 100.0]",Q4
36075,2020-03-13,117898,62,0,0,2,3,0.0,0.0,"(52.0, 100.0]",Q4
36075,2020-03-14,117898,62,0,0,2,5,0.0,0.0,"(52.0, 100.0]",Q4
36075,2020-03-15,117898,62,0,0,0,5,0.0,0.0,"(52.0, 100.0]",Q4
36075,2020-03-16,117898,62,0,0,4,9,0.0,0.0,"(52.0, 100.0]",Q4
36075,2020-03-17,117898,62,0,0,3,12,0.0,0.0,"(52.0, 100.0]",Q4
36075,2020-03-18,117898,62,0,0,8,20,0.0,0.0,"(52.0, 100.0]",Q4
36075,2020-03-19,117898,62,0,0,3,23,0.0,0.0,"(52.0, 100.0]",Q4
36075,2020-03-20,117898,62,0,0,11,34,0.0,0.0,"(52.0, 100.0]",Q4
36075,2020-03-21,117898,62,0,0,19,53,0.0,0.0,"(52.0, 100.0]",Q4
36075,2020-03-22,117898,62,1,1,23,76,0.14285714285714285,0.12117011557205623,"(52.0, 100.0]",Q4
36075,2020-03-23,117898,62,1,2,28,104,0.2857142857142857,0.24234023114411246,"(52.0, 100.0]",Q4
36075,2020-03-24,117898,62,0,2,13,117,0.2857142857142857,0.24234023114411246,"(52.0, 100.0]",Q4
36075,2020-03-25,117898,62,2,4,25,142,0.5714285714285714,0.4846804622882249,"(52.0, 100.0]",Q4
36075,2020-03-26,117898,62,0,4,18,160,0.5714285714285714,0.4846804622882249,"(52.0, 100.0]",Q4
36075,2020-03-27,117898,62,3,7,38,198,1.0,0.8481908090043937,"(52.0, 100.0]",Q4
36075,2020-03-28,117898,62,1,8,35,233,1.1428571428571428,0.9693609245764498,"(52.0, 100.0]",Q4
36075,2020-03-29,117898,62,6,14,53,286,1.8571428571428572,1.575211502436731,"(52.0, 100.0]",Q4
36075,2020-03-30,117898,62,1,15,30,316,1.8571428571428572,1.575211502436731,"(52.0, 100.0]",Q4
36075,2020-03-31,117898,62,2,17,27,343,2.142857142857143,1.8175517335808433,"(52.0, 100.0]",Q4
36075,2020-04-01,117898,62,5,22,80,423,2.5714285714285716,2.1810620802970124,"(52.0, 100.0]",Q4
36075,2020-04-02,117898,62,4,26,82,505,3.142857142857143,2.665742542585237,"(52.0, 100.0]",Q4
36075,2020-04-03,117898,62,0,26,31,536,2.7142857142857144,2.3022321958690686,"(52.0, 100.0]",Q4
36075,2020-04-04,117898,62,2,28,26,562,2.857142857142857,2.4234023114411247,"(52.0, 100.0]",Q4
36075,2020-04-05,117898,62,1,29,39,601,2.142857142857143,1.8175517335808433,"(52.0, 100.0]",Q4
36075,2020-04-06,117898,62,2,31,70,671,2.2857142857142856,1.9387218491528997,"(52.0, 100.0]",Q4
36075,2020-04-07,117898,62,2,33,27,698,2.2857142857142856,1.9387218491528997,"(52.0, 100.0]",Q4
36075,2020-04-08,117898,62,3,36,61,759,2.0,1.6963816180087874,"(52.0, 100.0]",Q4
36075,2020-04-09,117898,62,0,36,32,791,1.4285714285714286,1.2117011557205624,"(52.0, 100.0]",Q4
36075,2020-04-10,117898,62,1,37,12,803,1.5714285714285714,1.3328712712926185,"(52.0, 100.0]",Q4
36075,2020-04-11,117898,62,1,38,15,818,1.4285714285714286,1.2117011557205624,"(52.0, 100.0]",Q4
36075,2020-04-12,117898,62,0,38,10,828,1.2857142857142858,1.0905310401485062,"(52.0, 100.0]",Q4
36075,2020-04-13,117898,62,3,41,74,902,1.4285714285714286,1.2117011557205624,"(52.0, 100.0]",Q4
36075,2020-04-14,117898,62,1,42,17,919,1.2857142857142858,1.0905310401485062,"(52.0, 100.0]",Q4
36075,2020-04-15,117898,62,2,44,18,937,1.1428571428571428,0.9693609245764498,"(52.0, 100.0]",Q4
36075,2020-04-16,117898,62,1,45,28,965,1.2857142857142858,1.0905310401485062,"(52.0, 100.0]",Q4
36075,2020-04-17,117898,62,0,45,14,979,1.1428571428571428,0.9693609245764498,"(52.0, 100.0]",Q4
36075,2020-04-18,117898,62,2,47,18,997,1.2857142857142858,1.0905310401485062,"(52.0, 100.0]",Q4
36075,2020-04-19,117898,62,1,48,18,1015,1.4285714285714286,1.2117011557205624,"(52.0, 100.0]",Q4
36075,2020-04-20,117898,62,1,49,12,1027,1.1428571428571428,0.9693609245764498,"(52.0, 100.0]",Q4
36075,2020-04-21,117898,62,0,49,4,1031,1.0,0.8481908090043937,"(52.0, 100.0]",Q4
36075,2020-04-22,117898,62,0,49,21,1052,0.7142857142857143,0.6058505778602812,"(52.0, 100.0]",Q4
36075,2020-04-23,117898,62,2,51,18,1070,0.8571428571428571,0.7270206934323373,"(52.0, 100.0]",Q4
36075,2020-04-24,117898,62,6,57,298,1368,1.7142857142857142,1.4540413868646747,"(52.0, 100.0]",Q4
36075,2020-04-25,117898,62,4,61,67,1435,2.0,1.6963816180087874,"(52.0, 100.0]",Q4
36075,2020-04-26,117898,62,0,61,33,1468,1.8571428571428572,1.575211502436731,"(52.0, 100.0]",Q4
36075,2020-04-27,117898,62,2,63,40,1508,2.0,1.6963816180087874,"(52.0, 100.0]",Q4
36075,2020-04-28,117898,62,0,63,39,1547,2.0,1.6963816180087874,"(52.0, 100.0]",Q4
36075,2020-04-29,117898,62,0,63,45,1592,2.0,1.6963816180087874,"(52.0, 100.0]",Q4
36075,2020-04-30,117898,62,1,64,36,1628,1.8571428571428572,1.575211502436731,"(52.0, 100.0]",Q4
36075,2020-05-01,117898,62,2,66,30,1658,1.2857142857142858,1.0905310401485062,"(52.0, 100.0]",Q4
36075,2020-05-02,117898,62,0,66,37,1695,0.7142857142857143,0.6058505778602812,"(52.0, 100.0]",Q4
36075,2020-05-03,117898,62,1,67,44,1739,0.8571428571428571,0.7270206934323373,"(52.0, 100.0]",Q4
36075,2020-05-04,117898,62,1,68,40,1779,0.7142857142857143,0.6058505778602812,"(52.0, 100.0]",Q4
36075,2020-05-05,117898,62,2,70,41,1820,1.0,0.8481908090043937,"(52.0, 100.0]",Q4
36075,2020-05-06,117898,62,0,70,48,1868,1.0,0.8481908090043937,"(52.0, 100.0]",Q4
36075,2020-05-07,117898,62,2,72,54,1922,1.1428571428571428,0.9693609245764498,"(52.0, 100.0]",Q4
36075,2020-05-08,117898,62,3,75,52,1974,1.2857142857142858,1.0905310401485062,"(52.0, 100.0]",Q4
36075,2020-05-09,117898,62,0,75,59,2033,1.2857142857142858,1.0905310401485062,"(52.0, 100.0]",Q4
36075,2020-05-10,117898,62,0,75,49,2082,1.1428571428571428,0.9693609245764498,"(52.0, 100.0]",Q4
36075,2020-05-11,117898,62,1,76,53,2135,1.1428571428571428,0.9693609245764498,"(52.0, 100.0]",Q4
36075,2020-05-12,117898,62,0,76,59,2194,0.8571428571428571,0.7270206934323373,"(52.0, 100.0]",Q4
36075,2020-05-13,117898,62,2,78,64,2258,1.1428571428571428,0.9693609245764498,"(52.0, 100.0]",Q4
36075,2020-05-14,117898,62,2,80,110,2368,1.1428571428571428,0.9693609245764498,"(52.0, 100.0]",Q4
36075,2020-05-15,117898,62,3,83,241,2609,1.1428571428571428,0.9693609245764498,"(52.0, 100.0]",Q4
36075,2020-05-16,117898,62,1,84,81,2690,1.2857142857142858,1.0905310401485062,"(52.0, 100.0]",Q4
36075,2020-05-17,117898,62,0,84,197,2887,1.2857142857142858,1.0905310401485062,"(52.0, 100.0]",Q4
36075,2020-05-18,117898,62,5,89,95,2982,1.8571428571428572,1.575211502436731,"(52.0, 100.0]",Q4
36075,2020-05-19,117898,62,1,90,129,3111,2.0,1.6963816180087874,"(52.0, 100.0]",Q4
36075,2020-05-20,117898,62,2,92,300,3411,2.0,1.6963816180087874,"(52.0, 100.0]",Q4
36075,2020-05-21,117898,62,4,96,215,3626,2.2857142857142856,1.9387218491528997,"(52.0, 100.0]",Q4
36075,2020-05-22,117898,62,3,99,302,3928,2.2857142857142856,1.9387218491528997,"(52.0, 100.0]",Q4
36075,2020-05-23,117898,62,1,100,479,4407,2.2857142857142856,1.9387218491528997,"(52.0, 100.0]",Q4
36075,2020-05-24,117898,62,4,104,131,4538,2.857142857142857,2.4234023114411247,"(52.0, 100.0]",Q4
36075,2020-05-25,117898,62,0,104,175,4713,2.142857142857143,1.8175517335808433,"(52.0, 100.0]",Q4
36075,2020-05-26,117898,62,1,105,337,5050,2.142857142857143,1.8175517335808433,"(52.0, 100.0]",Q4
36075,2020-05-27,117898,62,2,107,260,5310,2.142857142857143,1.8175517335808433,"(52.0, 100.0]",Q4
36075,2020-05-28,117898,62,1,108,252,5562,1.7142857142857142,1.4540413868646747,"(52.0, 100.0]",Q4
36075,2020-05-29,117898,62,0,108,317,5879,1.2857142857142858,1.0905310401485062,"(52.0, 100.0]",Q4
36075,2020-05-30,117898,62,1,109,443,6322,1.2857142857142858,1.0905310401485062,"(52.0, 100.0]",Q4
36075,2020-05-31,117898,62,1,110,138,6460,0.8571428571428571,0.7270206934323373,"(52.0, 100.0]",Q4
36075,2020-06-01,117898,62,0,110,308,6768,0.8571428571428571,0.7270206934323373,"(52.0, 100.0]",Q4
36075,2020-06-02,117898,62,2,112,409,7177,1.0,0.8481908090043937,"(52.0, 100.0]",Q4
36075,2020-06-03,117898,62,0,112,185,7362,0.7142857142857143,0.6058505778602812,"(52.0, 100.0]",Q4
36075,2020-06-04,117898,62,0,112,609,7971,0.5714285714285714,0.4846804622882249,"(52.0, 100.0]",Q4
36075,2020-06-05,117898,62,2,114,475,8446,0.8571428571428571,0.7270206934323373,"(52.0, 100.0]",Q4
36075,2020-06-06,117898,62,1,115,272,8718,0.8571428571428571,0.7270206934323373,"(52.0, 100.0]",Q4
36075,2020-06-07,117898,62,0,115,414,9132,0.7142857142857143,0.6058505778602812,"(52.0, 100.0]",Q4
36077,2020-03-02,59749,36,0,0,0,0,0.0,0.0,"(24.0, 37.5]",Q2
36077,2020-03-03,59749,36,0,0,0,0,0.0,0.0,"(24.0, 37.5]",Q2
36077,2020-03-04,59749,36,0,0,0,0,0.0,0.0,"(24.0, 37.5]",Q2
36077,2020-03-05,59749,36,0,0,0,0,0.0,0.0,"(24.0, 37.5]",Q2
36077,2020-03-06,59749,36,0,0,0,0,0.0,0.0,"(24.0, 37.5]",Q2
36077,2020-03-07,59749,36,0,0,1,1,0.0,0.0,"(24.0, 37.5]",Q2
36077,2020-03-08,59749,36,0,0,1,2,0.0,0.0,"(24.0, 37.5]",Q2
36077,2020-03-09,59749,36,0,0,0,2,0.0,0.0,"(24.0, 37.5]",Q2
36077,2020-03-10,59749,36,0,0,0,2,0.0,0.0,"(24.0, 37.5]",Q2
36077,2020-03-11,59749,36,0,0,0,2,0.0,0.0,"(24.0, 37.5]",Q2
36077,2020-03-12,59749,36,0,0,0,2,0.0,0.0,"(24.0, 37.5]",Q2
36077,2020-03-13,59749,36,0,0,1,3,0.0,0.0,"(24.0, 37.5]",Q2
36077,2020-03-14,59749,36,0,0,2,5,0.0,0.0,"(24.0, 37.5]",Q2
36077,2020-03-15,59749,36,0,0,1,6,0.0,0.0,"(24.0, 37.5]",Q2
36077,2020-03-16,59749,36,0,0,0,6,0.0,0.0,"(24.0, 37.5]",Q2
36077,2020-03-17,59749,36,0,0,1,7,0.0,0.0,"(24.0, 37.5]",Q2
36077,2020-03-18,59749,36,0,0,2,9,0.0,0.0,"(24.0, 37.5]",Q2
36077,2020-03-19,59749,36,0,0,10,19,0.0,0.0,"(24.0, 37.5]",Q2
36077,2020-03-20,59749,36,0,0,20,39,0.0,0.0,"(24.0, 37.5]",Q2
36077,2020-03-21,59749,36,0,0,11,50,0.0,0.0,"(24.0, 37.5]",Q2
36077,2020-03-22,59749,36,1,1,10,60,0.14285714285714285,0.23909545407813157,"(24.0, 37.5]",Q2
36077,2020-03-23,59749,36,0,1,11,71,0.14285714285714285,0.23909545407813157,"(24.0, 37.5]",Q2
36077,2020-03-24,59749,36,1,2,5,76,0.2857142857142857,0.47819090815626314,"(24.0, 37.5]",Q2
36077,2020-03-25,59749,36,1,3,6,82,0.42857142857142855,0.7172863622343948,"(24.0, 37.5]",Q2
36077,2020-03-26,59749,36,2,5,12,94,0.7142857142857143,1.1954772703906582,"(24.0, 37.5]",Q2
36077,2020-03-27,59749,36,2,7,19,113,1.0,1.6736681785469214,"(24.0, 37.5]",Q2
36077,2020-03-28,59749,36,3,10,21,134,1.4285714285714286,2.3909545407813164,"(24.0, 37.5]",Q2
36077,2020-03-29,59749,36,7,17,16,150,2.2857142857142856,3.825527265250105,"(24.0, 37.5]",Q2
36077,2020-03-30,59749,36,1,18,8,158,2.4285714285714284,4.064622719328237,"(24.0, 37.5]",Q2
36077,2020-03-31,59749,36,1,19,19,177,2.4285714285714284,4.064622719328237,"(24.0, 37.5]",Q2
36077,2020-04-01,59749,36,2,21,17,194,2.5714285714285716,4.303718173406369,"(24.0, 37.5]",Q2
36077,2020-04-02,59749,36,0,21,12,206,2.2857142857142856,3.825527265250105,"(24.0, 37.5]",Q2
36077,2020-04-03,59749,36,5,26,53,259,2.7142857142857144,4.5428136274845015,"(24.0, 37.5]",Q2
36077,2020-04-04,59749,36,3,29,25,284,2.7142857142857144,4.5428136274845015,"(24.0, 37.5]",Q2
36077,2020-04-05,59749,36,5,34,41,325,2.4285714285714284,4.064622719328237,"(24.0, 37.5]",Q2
36077,2020-04-06,59749,36,0,34,43,368,2.2857142857142856,3.825527265250105,"(24.0, 37.5]",Q2
36077,2020-04-07,59749,36,4,38,31,399,2.7142857142857144,4.5428136274845015,"(24.0, 37.5]",Q2
36077,2020-04-08,59749,36,1,39,42,441,2.5714285714285716,4.303718173406369,"(24.0, 37.5]",Q2
36077,2020-04-09,59749,36,2,41,40,481,2.857142857142857,4.781909081562633,"(24.0, 37.5]",Q2
36077,2020-04-10,59749,36,2,43,34,515,2.4285714285714284,4.064622719328237,"(24.0, 37.5]",Q2
36077,2020-04-11,59749,36,0,43,15,530,2.0,3.347336357093843,"(24.0, 37.5]",Q2
36077,2020-04-12,59749,36,0,43,35,565,1.2857142857142858,2.1518590867031846,"(24.0, 37.5]",Q2
36077,2020-04-13,59749,36,1,44,90,655,1.4285714285714286,2.3909545407813164,"(24.0, 37.5]",Q2
36077,2020-04-14,59749,36,0,44,14,669,0.8571428571428571,1.4345727244687896,"(24.0, 37.5]",Q2
36077,2020-04-15,59749,36,0,44,15,684,0.7142857142857143,1.1954772703906582,"(24.0, 37.5]",Q2
36077,2020-04-16,59749,36,0,44,9,693,0.42857142857142855,0.7172863622343948,"(24.0, 37.5]",Q2
36077,2020-04-17,59749,36,3,47,18,711,0.5714285714285714,0.9563818163125263,"(24.0, 37.5]",Q2
36077,2020-04-18,59749,36,1,48,18,729,0.7142857142857143,1.1954772703906582,"(24.0, 37.5]",Q2
36077,2020-04-19,59749,36,1,49,10,739,0.8571428571428571,1.4345727244687896,"(24.0, 37.5]",Q2
36077,2020-04-20,59749,36,0,49,10,749,0.7142857142857143,1.1954772703906582,"(24.0, 37.5]",Q2
36077,2020-04-21,59749,36,0,49,15,764,0.7142857142857143,1.1954772703906582,"(24.0, 37.5]",Q2
36077,2020-04-22,59749,36,1,50,22,786,0.8571428571428571,1.4345727244687896,"(24.0, 37.5]",Q2
36077,2020-04-23,59749,36,0,50,18,804,0.8571428571428571,1.4345727244687896,"(24.0, 37.5]",Q2
36077,2020-04-24,59749,36,10,60,249,1053,1.8571428571428572,3.1082409030157105,"(24.0, 37.5]",Q2
36077,2020-04-25,59749,36,0,60,43,1096,1.7142857142857142,2.869145448937579,"(24.0, 37.5]",Q2
36077,2020-04-26,59749,36,2,62,38,1134,1.8571428571428572,3.1082409030157105,"(24.0, 37.5]",Q2
36077,2020-04-27,59749,36,3,65,33,1167,2.2857142857142856,3.825527265250105,"(24.0, 37.5]",Q2
36077,2020-04-28,59749,36,1,66,34,1201,2.4285714285714284,4.064622719328237,"(24.0, 37.5]",Q2
36077,2020-04-29,59749,36,1,67,45,1246,2.4285714285714284,4.064622719328237,"(24.0, 37.5]",Q2
36077,2020-04-30,59749,36,0,67,40,1286,2.4285714285714284,4.064622719328237,"(24.0, 37.5]",Q2
36077,2020-05-01,59749,36,0,67,88,1374,1.0,1.6736681785469214,"(24.0, 37.5]",Q2
36077,2020-05-02,59749,36,0,67,42,1416,1.0,1.6736681785469214,"(24.0, 37.5]",Q2
36077,2020-05-03,59749,36,0,67,36,1452,0.7142857142857143,1.1954772703906582,"(24.0, 37.5]",Q2
36077,2020-05-04,59749,36,0,67,87,1539,0.2857142857142857,0.47819090815626314,"(24.0, 37.5]",Q2
36077,2020-05-05,59749,36,0,67,70,1609,0.14285714285714285,0.23909545407813157,"(24.0, 37.5]",Q2
36077,2020-05-06,59749,36,0,67,43,1652,0.0,0.0,"(24.0, 37.5]",Q2
36077,2020-05-07,59749,36,0,67,44,1696,0.0,0.0,"(24.0, 37.5]",Q2
36077,2020-05-08,59749,36,0,67,39,1735,0.0,0.0,"(24.0, 37.5]",Q2
36077,2020-05-09,59749,36,0,67,46,1781,0.0,0.0,"(24.0, 37.5]",Q2
36077,2020-05-10,59749,36,0,67,40,1821,0.0,0.0,"(24.0, 37.5]",Q2
36077,2020-05-11,59749,36,0,67,62,1883,0.0,0.0,"(24.0, 37.5]",Q2
36077,2020-05-12,59749,36,0,67,82,1965,0.0,0.0,"(24.0, 37.5]",Q2
36077,2020-05-13,59749,36,0,67,45,2010,0.0,0.0,"(24.0, 37.5]",Q2
36077,2020-05-14,59749,36,0,67,27,2037,0.0,0.0,"(24.0, 37.5]",Q2
36077,2020-05-15,59749,36,0,67,181,2218,0.0,0.0,"(24.0, 37.5]",Q2
36077,2020-05-16,59749,36,0,67,50,2268,0.0,0.0,"(24.0, 37.5]",Q2
36077,2020-05-17,59749,36,0,67,79,2347,0.0,0.0,"(24.0, 37.5]",Q2
36077,2020-05-18,59749,36,0,67,129,2476,0.0,0.0,"(24.0, 37.5]",Q2
36077,2020-05-19,59749,36,0,67,124,2600,0.0,0.0,"(24.0, 37.5]",Q2
36077,2020-05-20,59749,36,0,67,65,2665,0.0,0.0,"(24.0, 37.5]",Q2
36077,2020-05-21,59749,36,0,67,102,2767,0.0,0.0,"(24.0, 37.5]",Q2
36077,2020-05-22,59749,36,1,68,90,2857,0.14285714285714285,0.23909545407813157,"(24.0, 37.5]",Q2
36077,2020-05-23,59749,36,1,69,51,2908,0.2857142857142857,0.47819090815626314,"(24.0, 37.5]",Q2
36077,2020-05-24,59749,36,0,69,38,2946,0.2857142857142857,0.47819090815626314,"(24.0, 37.5]",Q2
36077,2020-05-25,59749,36,0,69,17,2963,0.2857142857142857,0.47819090815626314,"(24.0, 37.5]",Q2
36077,2020-05-26,59749,36,0,69,243,3206,0.2857142857142857,0.47819090815626314,"(24.0, 37.5]",Q2
36077,2020-05-27,59749,36,1,70,191,3397,0.42857142857142855,0.7172863622343948,"(24.0, 37.5]",Q2
36077,2020-05-28,59749,36,1,71,128,3525,0.5714285714285714,0.9563818163125263,"(24.0, 37.5]",Q2
36077,2020-05-29,59749,36,0,71,127,3652,0.42857142857142855,0.7172863622343948,"(24.0, 37.5]",Q2
36077,2020-05-30,59749,36,1,72,184,3836,0.42857142857142855,0.7172863622343948,"(24.0, 37.5]",Q2
36077,2020-05-31,59749,36,0,72,93,3929,0.42857142857142855,0.7172863622343948,"(24.0, 37.5]",Q2
36077,2020-06-01,59749,36,1,73,189,4118,0.5714285714285714,0.9563818163125263,"(24.0, 37.5]",Q2
36077,2020-06-02,59749,36,0,73,183,4301,0.5714285714285714,0.9563818163125263,"(24.0, 37.5]",Q2
36077,2020-06-03,59749,36,0,73,112,4413,0.42857142857142855,0.7172863622343948,"(24.0, 37.5]",Q2
36077,2020-06-04,59749,36,0,73,132,4545,0.2857142857142857,0.47819090815626314,"(24.0, 37.5]",Q2
36077,2020-06-05,59749,36,1,74,265,4810,0.42857142857142855,0.7172863622343948,"(24.0, 37.5]",Q2
36077,2020-06-06,59749,36,0,74,163,4973,0.2857142857142857,0.47819090815626314,"(24.0, 37.5]",Q2
36077,2020-06-07,59749,36,1,75,144,5117,0.42857142857142855,0.7172863622343948,"(24.0, 37.5]",Q2
36079,2020-03-02,98892,4,0,0,0,0,0.0,0.0,"(3.999, 24.0]",Q1
36079,2020-03-03,98892,4,0,0,0,0,0.0,0.0,"(3.999, 24.0]",Q1
36079,2020-03-04,98892,4,0,0,0,0,0.0,0.0,"(3.999, 24.0]",Q1
36079,2020-03-05,98892,4,0,0,1,1,0.0,0.0,"(3.999, 24.0]",Q1
36079,2020-03-06,98892,4,0,0,0,1,0.0,0.0,"(3.999, 24.0]",Q1
36079,2020-03-07,98892,4,0,0,1,2,0.0,0.0,"(3.999, 24.0]",Q1
36079,2020-03-08,98892,4,0,0,0,2,0.0,0.0,"(3.999, 24.0]",Q1
36079,2020-03-09,98892,4,0,0,1,3,0.0,0.0,"(3.999, 24.0]",Q1
36079,2020-03-10,98892,4,0,0,0,3,0.0,0.0,"(3.999, 24.0]",Q1
36079,2020-03-11,98892,4,0,0,7,10,0.0,0.0,"(3.999, 24.0]",Q1
36079,2020-03-12,98892,4,0,0,1,11,0.0,0.0,"(3.999, 24.0]",Q1
36079,2020-03-13,98892,4,0,0,14,25,0.0,0.0,"(3.999, 24.0]",Q1
36079,2020-03-14,98892,4,0,0,3,28,0.0,0.0,"(3.999, 24.0]",Q1
36079,2020-03-15,98892,4,2,2,10,38,0.2857142857142857,0.2889154691120472,"(3.999, 24.0]",Q1
36079,2020-03-16,98892,4,0,2,5,43,0.2857142857142857,0.2889154691120472,"(3.999, 24.0]",Q1
36079,2020-03-17,98892,4,0,2,7,50,0.2857142857142857,0.2889154691120472,"(3.999, 24.0]",Q1
36079,2020-03-18,98892,4,3,5,32,82,0.7142857142857143,0.722288672780118,"(3.999, 24.0]",Q1
36079,2020-03-19,98892,4,2,7,35,117,1.0,1.0112041418921651,"(3.999, 24.0]",Q1
36079,2020-03-20,98892,4,15,22,79,196,3.142857142857143,3.178070160232519,"(3.999, 24.0]",Q1
36079,2020-03-21,98892,4,15,37,75,271,5.285714285714286,5.3449361785728735,"(3.999, 24.0]",Q1
36079,2020-03-22,98892,4,8,45,47,318,6.142857142857143,6.211682585909015,"(3.999, 24.0]",Q1
36079,2020-03-23,98892,4,22,67,70,388,9.285714285714286,9.389752746141536,"(3.999, 24.0]",Q1
36079,2020-03-24,98892,4,16,83,51,439,11.571428571428571,11.701076499037912,"(3.999, 24.0]",Q1
36079,2020-03-25,98892,4,11,94,75,514,12.714285714285714,12.856738375486097,"(3.999, 24.0]",Q1
36079,2020-03-26,98892,4,17,111,47,561,14.857142857142858,15.023604393826455,"(3.999, 24.0]",Q1
36079,2020-03-27,98892,4,20,131,84,645,15.571428571428571,15.745893066606572,"(3.999, 24.0]",Q1
36079,2020-03-28,98892,4,13,144,41,686,15.285714285714286,15.456977597494525,"(3.999, 24.0]",Q1
36079,2020-03-29,98892,4,23,167,63,749,17.428571428571427,17.62384361583488,"(3.999, 24.0]",Q1
36079,2020-03-30,98892,4,19,186,71,820,17.0,17.190470412166807,"(3.999, 24.0]",Q1
36079,2020-03-31,98892,4,21,207,57,877,17.714285714285715,17.912759084946927,"(3.999, 24.0]",Q1
36079,2020-04-01,98892,4,9,216,46,923,17.428571428571427,17.62384361583488,"(3.999, 24.0]",Q1
36079,2020-04-02,98892,4,36,252,90,1013,20.142857142857142,20.368540572399326,"(3.999, 24.0]",Q1
36079,2020-04-03,98892,4,31,283,96,1109,21.714285714285715,21.957575652515587,"(3.999, 24.0]",Q1
36079,2020-04-04,98892,4,31,314,78,1187,24.285714285714285,24.557814874524013,"(3.999, 24.0]",Q1
36079,2020-04-05,98892,4,31,345,122,1309,25.428571428571427,25.713476750972195,"(3.999, 24.0]",Q1
36079,2020-04-06,98892,4,21,366,72,1381,25.714285714285715,26.00239222008425,"(3.999, 24.0]",Q1
36079,2020-04-07,98892,4,37,403,115,1496,28.0,28.313715972980624,"(3.999, 24.0]",Q1
36079,2020-04-08,98892,4,35,438,158,1654,31.714285714285715,32.06961707143724,"(3.999, 24.0]",Q1
36079,2020-04-09,98892,4,49,487,169,1823,33.57142857142857,33.947567620665545,"(3.999, 24.0]",Q1
36079,2020-04-10,98892,4,7,494,18,1841,30.142857142857142,30.480581991320975,"(3.999, 24.0]",Q1
36079,2020-04-11,98892,4,3,497,12,1853,26.142857142857142,26.435765423752315,"(3.999, 24.0]",Q1
36079,2020-04-12,98892,4,5,502,8,1861,22.428571428571427,22.679864325295704,"(3.999, 24.0]",Q1
36079,2020-04-13,98892,4,56,558,217,2078,27.428571428571427,27.735885034756528,"(3.999, 24.0]",Q1
36079,2020-04-14,98892,4,13,571,43,2121,24.0,24.268899405411965,"(3.999, 24.0]",Q1
36079,2020-04-15,98892,4,2,573,6,2127,19.285714285714285,19.501794165063185,"(3.999, 24.0]",Q1
36079,2020-04-16,98892,4,5,578,11,2138,13.0,13.145653844598147,"(3.999, 24.0]",Q1
36079,2020-04-17,98892,4,4,582,13,2151,12.571428571428571,12.712280640930077,"(3.999, 24.0]",Q1
36079,2020-04-18,98892,4,10,592,37,2188,13.571428571428571,13.723484782822242,"(3.999, 24.0]",Q1
36079,2020-04-19,98892,4,7,599,21,2209,13.857142857142858,14.01240025193429,"(3.999, 24.0]",Q1
36079,2020-04-20,98892,4,6,605,30,2239,6.714285714285714,6.789513524133109,"(3.999, 24.0]",Q1
36079,2020-04-21,98892,4,6,611,31,2270,5.714285714285714,5.778309382240944,"(3.999, 24.0]",Q1
36079,2020-04-22,98892,4,4,615,19,2289,6.0,6.067224851352991,"(3.999, 24.0]",Q1
36079,2020-04-23,98892,4,4,619,25,2314,5.857142857142857,5.922767116796967,"(3.999, 24.0]",Q1
36079,2020-04-24,98892,4,266,885,1134,3448,43.285714285714285,43.770693570475146,"(3.999, 24.0]",Q1
36079,2020-04-25,98892,4,19,904,112,3560,44.57142857142857,45.07081318147936,"(3.999, 24.0]",Q1
36079,2020-04-26,98892,4,21,925,127,3687,46.57142857142857,47.09322146526369,"(3.999, 24.0]",Q1
36079,2020-04-27,98892,4,7,932,82,3769,46.714285714285715,47.237679199819716,"(3.999, 24.0]",Q1
36079,2020-04-28,98892,4,14,946,150,3919,47.857142857142854,48.3933410762679,"(3.999, 24.0]",Q1
36079,2020-04-29,98892,4,24,970,251,4170,50.714285714285715,51.28249576738838,"(3.999, 24.0]",Q1
36079,2020-04-30,98892,4,20,990,144,4314,53.0,53.59381952028475,"(3.999, 24.0]",Q1
36079,2020-05-01,98892,4,13,1003,115,4429,16.857142857142858,17.046012677610786,"(3.999, 24.0]",Q1
36079,2020-05-02,98892,4,10,1013,90,4519,15.571428571428571,15.745893066606572,"(3.999, 24.0]",Q1
36079,2020-05-03,98892,4,13,1026,114,4633,14.428571428571429,14.590231190158383,"(3.999, 24.0]",Q1
36079,2020-05-04,98892,4,5,1031,87,4720,14.142857142857142,14.301315721046336,"(3.999, 24.0]",Q1
36079,2020-05-05,98892,4,9,1040,96,4816,13.428571428571429,13.579027048266218,"(3.999, 24.0]",Q1
36079,2020-05-06,98892,4,26,1066,317,5133,13.714285714285714,13.867942517378264,"(3.999, 24.0]",Q1
36079,2020-05-07,98892,4,8,1074,121,5254,12.0,12.134449702705982,"(3.999, 24.0]",Q1
36079,2020-05-08,98892,4,6,1080,161,5415,11.0,11.123245560813817,"(3.999, 24.0]",Q1
36079,2020-05-09,98892,4,9,1089,155,5570,10.857142857142858,10.978787826257793,"(3.999, 24.0]",Q1
36079,2020-05-10,98892,4,9,1098,122,5692,10.285714285714286,10.4009568880337,"(3.999, 24.0]",Q1
36079,2020-05-11,98892,4,0,1098,42,5734,9.571428571428571,9.67866821525358,"(3.999, 24.0]",Q1
36079,2020-05-12,98892,4,10,1108,138,5872,9.714285714285714,9.823125949809604,"(3.999, 24.0]",Q1
36079,2020-05-13,98892,4,7,1115,151,6023,7.0,7.078428993245156,"(3.999, 24.0]",Q1
36079,2020-05-14,98892,4,6,1121,149,6172,6.714285714285714,6.789513524133109,"(3.999, 24.0]",Q1
36079,2020-05-15,98892,4,6,1127,153,6325,6.714285714285714,6.789513524133109,"(3.999, 24.0]",Q1
36079,2020-05-16,98892,4,9,1136,131,6456,6.714285714285714,6.789513524133109,"(3.999, 24.0]",Q1
36079,2020-05-17,98892,4,5,1141,116,6572,6.142857142857143,6.211682585909015,"(3.999, 24.0]",Q1
36079,2020-05-18,98892,4,18,1159,125,6697,8.714285714285714,8.81192180791744,"(3.999, 24.0]",Q1
36079,2020-05-19,98892,4,9,1168,155,6852,8.571428571428571,8.667464073361415,"(3.999, 24.0]",Q1
36079,2020-05-20,98892,4,7,1175,165,7017,8.571428571428571,8.667464073361415,"(3.999, 24.0]",Q1
36079,2020-05-21,98892,4,12,1187,156,7173,9.428571428571429,9.534210480697558,"(3.999, 24.0]",Q1
36079,2020-05-22,98892,4,13,1200,236,7409,10.428571428571429,10.545414622589723,"(3.999, 24.0]",Q1
36079,2020-05-23,98892,4,8,1208,161,7570,10.285714285714286,10.4009568880337,"(3.999, 24.0]",Q1
36079,2020-05-24,98892,4,6,1214,185,7755,10.428571428571429,10.545414622589723,"(3.999, 24.0]",Q1
36079,2020-05-25,98892,4,8,1222,184,7939,9.0,9.100837277029486,"(3.999, 24.0]",Q1
36079,2020-05-26,98892,4,5,1227,125,8064,8.428571428571429,8.523006338805393,"(3.999, 24.0]",Q1
36079,2020-05-27,98892,4,9,1236,425,8489,8.714285714285714,8.81192180791744,"(3.999, 24.0]",Q1
36079,2020-05-28,98892,4,5,1241,194,8683,7.714285714285714,7.800717666025274,"(3.999, 24.0]",Q1
36079,2020-05-29,98892,4,7,1248,312,8995,6.857142857142857,6.933971258689132,"(3.999, 24.0]",Q1
36079,2020-05-30,98892,4,4,1252,264,9259,6.285714285714286,6.356140320465038,"(3.999, 24.0]",Q1
36079,2020-05-31,98892,4,5,1257,247,9506,6.142857142857143,6.211682585909015,"(3.999, 24.0]",Q1
36079,2020-06-01,98892,4,5,1262,248,9754,5.714285714285714,5.778309382240944,"(3.999, 24.0]",Q1
36079,2020-06-02,98892,4,2,1264,286,10040,5.285714285714286,5.3449361785728735,"(3.999, 24.0]",Q1
36079,2020-06-03,98892,4,4,1268,311,10351,4.571428571428571,4.622647505792755,"(3.999, 24.0]",Q1
36079,2020-06-04,98892,4,2,1270,313,10664,4.142857142857143,4.1892743021246845,"(3.999, 24.0]",Q1
36079,2020-06-05,98892,4,4,1274,306,10970,3.7142857142857144,3.7559010984566137,"(3.999, 24.0]",Q1
36079,2020-06-06,98892,4,3,1277,203,11173,3.5714285714285716,3.61144336390059,"(3.999, 24.0]",Q1
36079,2020-06-07,98892,4,2,1279,252,11425,3.142857142857143,3.178070160232519,"(3.999, 24.0]",Q1
36081,2020-03-02,2278906,83,0,0,0,0,0.0,0.0,"(52.0, 100.0]",Q4
36081,2020-03-03,2278906,83,0,0,2,2,0.0,0.0,"(52.0, 100.0]",Q4
36081,2020-03-04,2278906,83,0,0,0,2,0.0,0.0,"(52.0, 100.0]",Q4
36081,2020-03-05,2278906,83,1,1,6,8,1.0,0.043880704162435835,"(52.0, 100.0]",Q4
36081,2020-03-06,2278906,83,1,2,10,18,1.0,0.043880704162435835,"(52.0, 100.0]",Q4
36081,2020-03-07,2278906,83,0,2,14,32,0.0,0.0,"(52.0, 100.0]",Q4
36081,2020-03-08,2278906,83,1,3,13,45,0.42857142857142855,0.018806016069615357,"(52.0, 100.0]",Q4
36081,2020-03-09,2278906,83,0,3,15,60,0.42857142857142855,0.018806016069615357,"(52.0, 100.0]",Q4
36081,2020-03-10,2278906,83,4,7,18,78,1.0,0.043880704162435835,"(52.0, 100.0]",Q4
36081,2020-03-11,2278906,83,5,12,44,122,1.7142857142857142,0.07522406427846143,"(52.0, 100.0]",Q4
36081,2020-03-12,2278906,83,15,27,74,196,3.7142857142857144,0.1629854726033331,"(52.0, 100.0]",Q4
36081,2020-03-13,2278906,83,30,57,154,350,7.857142857142857,0.34477696127628155,"(52.0, 100.0]",Q4
36081,2020-03-14,2278906,83,18,75,110,460,10.428571428571429,0.45761305769397376,"(52.0, 100.0]",Q4
36081,2020-03-15,2278906,83,49,124,198,658,17.285714285714285,0.7585093148078194,"(52.0, 100.0]",Q4
36081,2020-03-16,2278906,83,38,162,136,794,22.714285714285715,0.996718851689614,"(52.0, 100.0]",Q4
36081,2020-03-17,2278906,83,123,285,371,1165,39.714285714285715,1.7426908224510231,"(52.0, 100.0]",Q4
36081,2020-03-18,2278906,83,336,621,768,1933,87.0,3.8176212621319174,"(52.0, 100.0]",Q4
36081,2020-03-19,2278906,83,519,1140,1179,3112,159.0,6.977031961827297,"(52.0, 100.0]",Q4
36081,2020-03-20,2278906,83,491,1631,1218,4330,224.85714285714286,9.866889764524858,"(52.0, 100.0]",Q4
36081,2020-03-21,2278906,83,843,2474,1927,6257,342.7142857142857,15.038544183669083,"(52.0, 100.0]",Q4
36081,2020-03-22,2278906,83,1152,3626,2048,8305,500.2857142857143,21.952889425264328,"(52.0, 100.0]",Q4
36081,2020-03-23,2278906,83,839,4465,1518,9823,614.7142857142857,26.974095715851625,"(52.0, 100.0]",Q4
36081,2020-03-24,2278906,83,1010,5475,1736,11559,741.4285714285714,32.53440780043457,"(52.0, 100.0]",Q4
36081,2020-03-25,2278906,83,1238,6713,2110,13669,870.2857142857143,38.18874996536559,"(52.0, 100.0]",Q4
36081,2020-03-26,2278906,83,1324,8037,2115,15784,985.2857142857143,43.23503094404571,"(52.0, 100.0]",Q4
36081,2020-03-27,2278906,83,1238,9275,2055,17839,1092.0,47.917728945379935,"(52.0, 100.0]",Q4
36081,2020-03-28,2278906,83,1136,10411,1845,19684,1133.857142857143,49.75444984817903,"(52.0, 100.0]",Q4
36081,2020-03-29,2278906,83,1258,11669,1915,21599,1149.0,50.418929082638776,"(52.0, 100.0]",Q4
36081,2020-03-30,2278906,83,2022,13691,3325,24924,1318.0,57.834768086090435,"(52.0, 100.0]",Q4
36081,2020-03-31,2278906,83,1211,14902,1871,26795,1346.7142857142858,59.09477116275466,"(52.0, 100.0]",Q4
36081,2020-04-01,2278906,83,1366,16268,2157,28952,1365.0,59.89716118172491,"(52.0, 100.0]",Q4
36081,2020-04-02,2278906,83,1899,18167,3048,32000,1447.142857142857,63.50164759506786,"(52.0, 100.0]",Q4
36081,2020-04-03,2278906,83,1947,20114,3407,35407,1548.4285714285713,67.94613605952028,"(52.0, 100.0]",Q4
36081,2020-04-04,2278906,83,1322,21436,2255,37662,1575.0,69.11210905583644,"(52.0, 100.0]",Q4
36081,2020-04-05,2278906,83,1697,23133,2730,40392,1637.7142857142858,71.8640560740235,"(52.0, 100.0]",Q4
36081,2020-04-06,2278906,83,1707,24840,2864,43256,1592.7142857142858,69.88942438671387,"(52.0, 100.0]",Q4
36081,2020-04-07,2278906,83,1408,26248,2884,46140,1620.857142857143,71.12435277528529,"(52.0, 100.0]",Q4
36081,2020-04-08,2278906,83,1504,27752,2831,48971,1640.5714285714287,71.9894295144876,"(52.0, 100.0]",Q4
36081,2020-04-09,2278906,83,1551,29303,2941,51912,1590.857142857143,69.8079316504122,"(52.0, 100.0]",Q4
36081,2020-04-10,2278906,83,1988,31291,3803,55715,1596.7142857142858,70.06494720336363,"(52.0, 100.0]",Q4
36081,2020-04-11,2278906,83,1544,32835,3219,58934,1628.4285714285713,71.45659239251515,"(52.0, 100.0]",Q4
36081,2020-04-12,2278906,83,1150,33985,2481,61415,1550.2857142857142,68.02762879582195,"(52.0, 100.0]",Q4
36081,2020-04-13,2278906,83,1068,35053,2430,63845,1459.0,64.02194737299389,"(52.0, 100.0]",Q4
36081,2020-04-14,2278906,83,1712,36765,3674,67519,1502.4285714285713,65.92762366804824,"(52.0, 100.0]",Q4
36081,2020-04-15,2278906,83,1153,37918,3144,70663,1452.2857142857142,63.72731978790324,"(52.0, 100.0]",Q4
36081,2020-04-16,2278906,83,1173,39091,3056,73719,1398.2857142857142,61.35776176313171,"(52.0, 100.0]",Q4
36081,2020-04-17,2278906,83,1125,40216,3347,77066,1275.0,55.9478978071057,"(52.0, 100.0]",Q4
36081,2020-04-18,2278906,83,1021,41237,3338,80404,1200.2857142857142,52.669382338969406,"(52.0, 100.0]",Q4
36081,2020-04-19,2278906,83,786,42023,2428,82832,1148.2857142857142,50.38758572252274,"(52.0, 100.0]",Q4
36081,2020-04-20,2278906,83,799,42822,2498,85330,1109.857142857143,48.701312948280574,"(52.0, 100.0]",Q4
36081,2020-04-21,2278906,83,891,43713,3058,88388,992.5714285714286,43.55473321722917,"(52.0, 100.0]",Q4
36081,2020-04-22,2278906,83,1191,44904,4142,92530,998.0,43.79294275411097,"(52.0, 100.0]",Q4
36081,2020-04-23,2278906,83,1483,46387,5468,97998,1042.2857142857142,45.73623108130455,"(52.0, 100.0]",Q4
36081,2020-04-24,2278906,83,1474,47861,5296,103294,1092.142857142857,47.92399761740314,"(52.0, 100.0]",Q4
36081,2020-04-25,2278906,83,884,48745,3676,106970,1072.5714285714287,47.06518955022404,"(52.0, 100.0]",Q4
36081,2020-04-26,2278906,83,654,49399,2829,109799,1053.7142857142858,46.23772484316096,"(52.0, 100.0]",Q4
36081,2020-04-27,2278906,83,530,49929,2628,112427,1015.2857142857143,44.551452068918785,"(52.0, 100.0]",Q4
36081,2020-04-28,2278906,83,812,50741,4061,116488,1004.0,44.05622697908558,"(52.0, 100.0]",Q4
36081,2020-04-29,2278906,83,890,51631,4201,120689,961.0,42.169356700100835,"(52.0, 100.0]",Q4
36081,2020-04-30,2278906,83,643,52274,3689,124378,841.0,36.90367220060854,"(52.0, 100.0]",Q4
36081,2020-05-01,2278906,83,765,53039,4517,128895,739.7142857142857,32.459183736156106,"(52.0, 100.0]",Q4
36081,2020-05-02,2278906,83,601,53640,3755,132650,699.2857142857143,30.68514955358906,"(52.0, 100.0]",Q4
36081,2020-05-03,2278906,83,450,54090,2696,135346,670.1428571428571,29.406340460855212,"(52.0, 100.0]",Q4
36081,2020-05-04,2278906,83,358,54448,2633,137979,645.5714285714286,28.32812887286393,"(52.0, 100.0]",Q4
36081,2020-05-05,2278906,83,432,54880,3591,141570,591.2857142857143,25.946033504045992,"(52.0, 100.0]",Q4
36081,2020-05-06,2278906,83,570,55450,4505,146075,545.5714285714286,23.940058456620353,"(52.0, 100.0]",Q4
36081,2020-05-07,2278906,83,494,55944,3992,150067,524.2857142857143,23.00602632516279,"(52.0, 100.0]",Q4
36081,2020-05-08,2278906,83,549,56493,4596,154663,493.42857142857144,21.651993168150483,"(52.0, 100.0]",Q4
36081,2020-05-09,2278906,83,369,56862,3416,158079,460.2857142857143,20.197661258766892,"(52.0, 100.0]",Q4
36081,2020-05-10,2278906,83,318,57180,2937,161016,441.42857142857144,19.370196551703817,"(52.0, 100.0]",Q4
36081,2020-05-11,2278906,83,211,57391,2552,163568,420.42857142857144,18.448701764292668,"(52.0, 100.0]",Q4
36081,2020-05-12,2278906,83,357,57748,3829,167397,409.7142857142857,17.97855136255228,"(52.0, 100.0]",Q4
36081,2020-05-13,2278906,83,336,58084,4439,171836,376.2857142857143,16.511682109122283,"(52.0, 100.0]",Q4
36081,2020-05-14,2278906,83,432,58516,4879,176715,367.42857142857144,16.12302444368357,"(52.0, 100.0]",Q4
36081,2020-05-15,2278906,83,325,58841,4644,181359,335.42857142857144,14.71884191048562,"(52.0, 100.0]",Q4
36081,2020-05-16,2278906,83,291,59132,4209,185568,324.2857142857143,14.229885492675622,"(52.0, 100.0]",Q4
36081,2020-05-17,2278906,83,192,59324,3226,188794,306.2857142857143,13.440032817751776,"(52.0, 100.0]",Q4
36081,2020-05-18,2278906,83,184,59508,3363,192157,302.42857142857144,13.270778673125239,"(52.0, 100.0]",Q4
36081,2020-05-19,2278906,83,244,59752,4581,196738,286.2857142857143,12.562418734503058,"(52.0, 100.0]",Q4
36081,2020-05-20,2278906,83,273,60025,5151,201889,277.2857142857143,12.167492397041135,"(52.0, 100.0]",Q4
36081,2020-05-21,2278906,83,211,60236,5181,207070,245.71428571428572,10.782115879912807,"(52.0, 100.0]",Q4
36081,2020-05-22,2278906,83,186,60422,5388,212458,225.85714285714286,9.910770468687295,"(52.0, 100.0]",Q4
36081,2020-05-23,2278906,83,214,60636,5270,217728,214.85714285714286,9.4280827229005,"(52.0, 100.0]",Q4
36081,2020-05-24,2278906,83,192,60828,4448,222176,214.85714285714286,9.4280827229005,"(52.0, 100.0]",Q4
36081,2020-05-25,2278906,83,132,60960,3789,225965,207.42857142857142,9.102111777693834,"(52.0, 100.0]",Q4
36081,2020-05-26,2278906,83,165,61125,4201,230166,196.14285714285714,8.606886687860628,"(52.0, 100.0]",Q4
36081,2020-05-27,2278906,83,275,61400,9126,239292,196.42857142857142,8.61942403190704,"(52.0, 100.0]",Q4
36081,2020-05-28,2278906,83,244,61644,8480,247772,201.14285714285714,8.826290208672807,"(52.0, 100.0]",Q4
36081,2020-05-29,2278906,83,183,61827,7088,254860,200.71428571428572,8.807484192603193,"(52.0, 100.0]",Q4
36081,2020-05-30,2278906,83,148,61975,6226,261086,191.28571428571428,8.393751839071655,"(52.0, 100.0]",Q4
36081,2020-05-31,2278906,83,119,62094,5906,266992,180.85714285714286,7.9361387813776805,"(52.0, 100.0]",Q4
36081,2020-06-01,2278906,83,199,62293,7231,274223,190.42857142857142,8.356139806932424,"(52.0, 100.0]",Q4
36081,2020-06-02,2278906,83,132,62425,6319,280542,185.71428571428572,8.149273630166656,"(52.0, 100.0]",Q4
36081,2020-06-03,2278906,83,117,62542,6451,286993,163.14285714285714,7.158823450500246,"(52.0, 100.0]",Q4
36081,2020-06-04,2278906,83,150,62692,6695,293688,149.71428571428572,6.569568280318966,"(52.0, 100.0]",Q4
36081,2020-06-05,2278906,83,158,62850,7672,301360,146.14285714285714,6.412851479738837,"(52.0, 100.0]",Q4
36081,2020-06-06,2278906,83,113,62963,6497,307857,141.14285714285714,6.193447958926658,"(52.0, 100.0]",Q4
36081,2020-06-07,2278906,83,134,63097,6514,314371,143.28571428571428,6.287478039274734,"(52.0, 100.0]",Q4
36083,2020-03-02,159442,37,0,0,0,0,0.0,0.0,"(24.0, 37.5]",Q2
36083,2020-03-03,159442,37,0,0,0,0,0.0,0.0,"(24.0, 37.5]",Q2
36083,2020-03-04,159442,37,0,0,2,2,0.0,0.0,"(24.0, 37.5]",Q2
36083,2020-03-05,159442,37,0,0,0,2,0.0,0.0,"(24.0, 37.5]",Q2
36083,2020-03-06,159442,37,0,0,0,2,0.0,0.0,"(24.0, 37.5]",Q2
36083,2020-03-07,159442,37,0,0,2,4,0.0,0.0,"(24.0, 37.5]",Q2
36083,2020-03-08,159442,37,0,0,0,4,0.0,0.0,"(24.0, 37.5]",Q2
36083,2020-03-09,159442,37,0,0,1,5,0.0,0.0,"(24.0, 37.5]",Q2
36083,2020-03-10,159442,37,0,0,1,6,0.0,0.0,"(24.0, 37.5]",Q2
36083,2020-03-11,159442,37,0,0,1,7,0.0,0.0,"(24.0, 37.5]",Q2
36083,2020-03-12,159442,37,0,0,2,9,0.0,0.0,"(24.0, 37.5]",Q2
36083,2020-03-13,159442,37,0,0,11,20,0.0,0.0,"(24.0, 37.5]",Q2
36083,2020-03-14,159442,37,0,0,40,60,0.0,0.0,"(24.0, 37.5]",Q2
36083,2020-03-15,159442,37,0,0,50,110,0.0,0.0,"(24.0, 37.5]",Q2
36083,2020-03-16,159442,37,1,1,39,149,0.14285714285714285,0.08959818796624656,"(24.0, 37.5]",Q2
36083,2020-03-17,159442,37,3,4,70,219,0.5714285714285714,0.35839275186498626,"(24.0, 37.5]",Q2
36083,2020-03-18,159442,37,2,6,136,355,0.8571428571428571,0.5375891277974794,"(24.0, 37.5]",Q2
36083,2020-03-19,159442,37,2,8,156,511,1.1428571428571428,0.7167855037299725,"(24.0, 37.5]",Q2
36083,2020-03-20,159442,37,12,20,166,677,2.857142857142857,1.7919637593249316,"(24.0, 37.5]",Q2
36083,2020-03-21,159442,37,6,26,173,850,3.7142857142857144,2.329552887122411,"(24.0, 37.5]",Q2
36083,2020-03-22,159442,37,3,29,78,928,4.142857142857143,2.5983474510211506,"(24.0, 37.5]",Q2
36083,2020-03-23,159442,37,1,30,47,975,4.142857142857143,2.5983474510211506,"(24.0, 37.5]",Q2
36083,2020-03-24,159442,37,1,31,26,1001,3.857142857142857,2.4191510750886573,"(24.0, 37.5]",Q2
36083,2020-03-25,159442,37,1,32,22,1023,3.7142857142857144,2.329552887122411,"(24.0, 37.5]",Q2
36083,2020-03-26,159442,37,3,35,26,1049,3.857142857142857,2.4191510750886573,"(24.0, 37.5]",Q2
36083,2020-03-27,159442,37,3,38,37,1086,2.5714285714285716,1.6127673833924385,"(24.0, 37.5]",Q2
36083,2020-03-28,159442,37,1,39,12,1098,1.8571428571428572,1.1647764435612056,"(24.0, 37.5]",Q2
36083,2020-03-29,159442,37,1,40,25,1123,1.5714285714285714,0.9855800676287122,"(24.0, 37.5]",Q2
36083,2020-03-30,159442,37,1,41,20,1143,1.5714285714285714,0.9855800676287122,"(24.0, 37.5]",Q2
36083,2020-03-31,159442,37,2,43,19,1162,1.7142857142857142,1.0751782555949587,"(24.0, 37.5]",Q2
36083,2020-04-01,159442,37,10,53,42,1204,3.0,1.8815619472911782,"(24.0, 37.5]",Q2
36083,2020-04-02,159442,37,3,56,31,1235,3.0,1.8815619472911782,"(24.0, 37.5]",Q2
36083,2020-04-03,159442,37,2,58,18,1253,2.857142857142857,1.7919637593249316,"(24.0, 37.5]",Q2
36083,2020-04-04,159442,37,2,60,48,1301,3.0,1.8815619472911782,"(24.0, 37.5]",Q2
36083,2020-04-05,159442,37,2,62,29,1330,3.142857142857143,1.9711601352574244,"(24.0, 37.5]",Q2
36083,2020-04-06,159442,37,5,67,30,1360,3.7142857142857144,2.329552887122411,"(24.0, 37.5]",Q2
36083,2020-04-07,159442,37,8,75,53,1413,4.571428571428571,2.86714201491989,"(24.0, 37.5]",Q2
36083,2020-04-08,159442,37,4,79,52,1465,3.7142857142857144,2.329552887122411,"(24.0, 37.5]",Q2
36083,2020-04-09,159442,37,12,91,101,1566,5.0,3.1359365788186295,"(24.0, 37.5]",Q2
36083,2020-04-10,159442,37,5,96,40,1606,5.428571428571429,3.4047311427173694,"(24.0, 37.5]",Q2
36083,2020-04-11,159442,37,9,105,65,1671,6.428571428571429,4.031918458481096,"(24.0, 37.5]",Q2
36083,2020-04-12,159442,37,8,113,61,1732,7.285714285714286,4.569507586278575,"(24.0, 37.5]",Q2
36083,2020-04-13,159442,37,7,120,79,1811,7.571428571428571,4.748703962211068,"(24.0, 37.5]",Q2
36083,2020-04-14,159442,37,4,124,42,1853,7.0,4.390311210346082,"(24.0, 37.5]",Q2
36083,2020-04-15,159442,37,13,137,106,1959,8.285714285714286,5.196694902042301,"(24.0, 37.5]",Q2
36083,2020-04-16,159442,37,13,150,100,2059,8.428571428571429,5.286293090008548,"(24.0, 37.5]",Q2
36083,2020-04-17,159442,37,14,164,135,2194,9.714285714285714,6.092676781704767,"(24.0, 37.5]",Q2
36083,2020-04-18,159442,37,9,173,117,2311,9.714285714285714,6.092676781704767,"(24.0, 37.5]",Q2
36083,2020-04-19,159442,37,4,177,51,2362,9.142857142857142,5.73428402983978,"(24.0, 37.5]",Q2
36083,2020-04-20,159442,37,6,183,50,2412,9.0,5.644685841873534,"(24.0, 37.5]",Q2
36083,2020-04-21,159442,37,3,186,49,2461,8.857142857142858,5.555087653907288,"(24.0, 37.5]",Q2
36083,2020-04-22,159442,37,5,191,52,2513,7.714285714285714,4.838302150177315,"(24.0, 37.5]",Q2
36083,2020-04-23,159442,37,7,198,80,2593,6.857142857142857,4.300713022379835,"(24.0, 37.5]",Q2
36083,2020-04-24,159442,37,23,221,209,2802,8.142857142857142,5.107096714076054,"(24.0, 37.5]",Q2
36083,2020-04-25,159442,37,21,242,151,2953,9.857142857142858,6.182274969671014,"(24.0, 37.5]",Q2
36083,2020-04-26,159442,37,4,246,83,3036,9.857142857142858,6.182274969671014,"(24.0, 37.5]",Q2
36083,2020-04-27,159442,37,4,250,39,3075,9.571428571428571,6.00307859373852,"(24.0, 37.5]",Q2
36083,2020-04-28,159442,37,12,262,91,3166,10.857142857142858,6.809462285434739,"(24.0, 37.5]",Q2
36083,2020-04-29,159442,37,25,287,142,3308,13.714285714285714,8.60142604475967,"(24.0, 37.5]",Q2
36083,2020-04-30,159442,37,11,298,101,3409,14.285714285714286,8.959818796624658,"(24.0, 37.5]",Q2
36083,2020-05-01,159442,37,13,311,112,3521,12.857142857142858,8.063836916962192,"(24.0, 37.5]",Q2
36083,2020-05-02,159442,37,11,322,170,3691,11.428571428571429,7.167855037299726,"(24.0, 37.5]",Q2
36083,2020-05-03,159442,37,15,337,148,3839,13.0,8.153435104928437,"(24.0, 37.5]",Q2
36083,2020-05-04,159442,37,2,339,71,3910,12.714285714285714,7.974238728995944,"(24.0, 37.5]",Q2
36083,2020-05-05,159442,37,8,347,126,4036,12.142857142857142,7.615845977130958,"(24.0, 37.5]",Q2
36083,2020-05-06,159442,37,20,367,159,4195,11.428571428571429,7.167855037299726,"(24.0, 37.5]",Q2
36083,2020-05-07,159442,37,13,380,194,4389,11.714285714285714,7.347051413232218,"(24.0, 37.5]",Q2
36083,2020-05-08,159442,37,27,407,187,4576,13.714285714285714,8.60142604475967,"(24.0, 37.5]",Q2
36083,2020-05-09,159442,37,2,409,248,4824,12.428571428571429,7.795042353063453,"(24.0, 37.5]",Q2
36083,2020-05-10,159442,37,2,411,62,4886,10.571428571428571,6.630265909502246,"(24.0, 37.5]",Q2
36083,2020-05-11,159442,37,5,416,91,4977,11.0,6.8990604734009855,"(24.0, 37.5]",Q2
36083,2020-05-12,159442,37,4,420,429,5406,10.428571428571429,6.540667721535999,"(24.0, 37.5]",Q2
36083,2020-05-13,159442,37,3,423,278,5684,8.0,5.017498526109808,"(24.0, 37.5]",Q2
36083,2020-05-14,159442,37,5,428,204,5888,6.857142857142857,4.300713022379835,"(24.0, 37.5]",Q2
36083,2020-05-15,159442,37,10,438,225,6113,4.428571428571429,2.777543826953644,"(24.0, 37.5]",Q2
36083,2020-05-16,159442,37,1,439,113,6226,4.285714285714286,2.6879456389873972,"(24.0, 37.5]",Q2
36083,2020-05-17,159442,37,5,444,198,6424,4.714285714285714,2.956740202886137,"(24.0, 37.5]",Q2
36083,2020-05-18,159442,37,0,444,76,6500,4.0,2.508749263054904,"(24.0, 37.5]",Q2
36083,2020-05-19,159442,37,9,453,292,6792,4.714285714285714,2.956740202886137,"(24.0, 37.5]",Q2
36083,2020-05-20,159442,37,3,456,403,7195,4.714285714285714,2.956740202886137,"(24.0, 37.5]",Q2
36083,2020-05-21,159442,37,4,460,379,7574,4.571428571428571,2.86714201491989,"(24.0, 37.5]",Q2
36083,2020-05-22,159442,37,3,463,386,7960,3.5714285714285716,2.2399546991561645,"(24.0, 37.5]",Q2
36083,2020-05-23,159442,37,0,463,363,8323,3.4285714285714284,2.1503565111899174,"(24.0, 37.5]",Q2
36083,2020-05-24,159442,37,2,465,123,8446,3.0,1.8815619472911782,"(24.0, 37.5]",Q2
36083,2020-05-25,159442,37,1,466,158,8604,3.142857142857143,1.9711601352574244,"(24.0, 37.5]",Q2
36083,2020-05-26,159442,37,0,466,150,8754,1.8571428571428572,1.1647764435612056,"(24.0, 37.5]",Q2
36083,2020-05-27,159442,37,3,469,405,9159,1.8571428571428572,1.1647764435612056,"(24.0, 37.5]",Q2
36083,2020-05-28,159442,37,9,478,319,9478,2.5714285714285716,1.6127673833924385,"(24.0, 37.5]",Q2
36083,2020-05-29,159442,37,8,486,337,9815,3.2857142857142856,2.0607583232236713,"(24.0, 37.5]",Q2
36083,2020-05-30,159442,37,5,491,313,10128,4.0,2.508749263054904,"(24.0, 37.5]",Q2
36083,2020-05-31,159442,37,1,492,274,10402,3.857142857142857,2.4191510750886573,"(24.0, 37.5]",Q2
36083,2020-06-01,159442,37,1,493,168,10570,3.857142857142857,2.4191510750886573,"(24.0, 37.5]",Q2
36083,2020-06-02,159442,37,2,495,426,10996,4.142857142857143,2.5983474510211506,"(24.0, 37.5]",Q2
36083,2020-06-03,159442,37,0,495,312,11308,3.7142857142857144,2.329552887122411,"(24.0, 37.5]",Q2
36083,2020-06-04,159442,37,2,497,592,11900,2.7142857142857144,1.7023655713586847,"(24.0, 37.5]",Q2
36083,2020-06-05,159442,37,2,499,332,12232,1.8571428571428572,1.1647764435612056,"(24.0, 37.5]",Q2
36083,2020-06-06,159442,37,3,502,421,12653,1.5714285714285714,0.9855800676287122,"(24.0, 37.5]",Q2
36083,2020-06-07,159442,37,1,503,517,13170,1.5714285714285714,0.9855800676287122,"(24.0, 37.5]",Q2
36085,2020-03-02,476179,40,0,0,0,0,0.0,0.0,"(37.5, 52.0]",Q3
36085,2020-03-03,476179,40,0,0,0,0,0.0,0.0,"(37.5, 52.0]",Q3
36085,2020-03-04,476179,40,0,0,0,0,0.0,0.0,"(37.5, 52.0]",Q3
36085,2020-03-05,476179,40,0,0,0,0,0.0,0.0,"(37.5, 52.0]",Q3
36085,2020-03-06,476179,40,0,0,3,3,0.0,0.0,"(37.5, 52.0]",Q3
36085,2020-03-07,476179,40,0,0,2,5,0.0,0.0,"(37.5, 52.0]",Q3
36085,2020-03-08,476179,40,0,0,0,5,0.0,0.0,"(37.5, 52.0]",Q3
36085,2020-03-09,476179,40,0,0,6,11,0.0,0.0,"(37.5, 52.0]",Q3
36085,2020-03-10,476179,40,1,1,5,16,0.14285714285714285,0.030000723017424718,"(37.5, 52.0]",Q3
36085,2020-03-11,476179,40,1,2,5,21,0.2857142857142857,0.060001446034849436,"(37.5, 52.0]",Q3
36085,2020-03-12,476179,40,4,6,16,37,0.8571428571428571,0.18000433810454833,"(37.5, 52.0]",Q3
36085,2020-03-13,476179,40,5,11,34,71,1.5714285714285714,0.3300079531916719,"(37.5, 52.0]",Q3
36085,2020-03-14,476179,40,3,14,29,100,2.0,0.420010122243946,"(37.5, 52.0]",Q3
36085,2020-03-15,476179,40,6,20,27,127,2.857142857142857,0.6000144603484944,"(37.5, 52.0]",Q3
36085,2020-03-16,476179,40,11,31,35,162,4.428571428571429,0.9300224135401665,"(37.5, 52.0]",Q3
36085,2020-03-17,476179,40,26,57,61,223,8.0,1.680040488975784,"(37.5, 52.0]",Q3
36085,2020-03-18,476179,40,33,90,110,333,12.571428571428571,2.6400636255333754,"(37.5, 52.0]",Q3
36085,2020-03-19,476179,40,116,206,272,605,28.571428571428573,6.000144603484944,"(37.5, 52.0]",Q3
36085,2020-03-20,476179,40,109,315,334,939,43.42857142857143,9.120219797297116,"(37.5, 52.0]",Q3
36085,2020-03-21,476179,40,207,522,645,1584,72.57142857142857,15.240367292851758,"(37.5, 52.0]",Q3
36085,2020-03-22,476179,40,193,715,417,2001,99.28571428571429,20.85050249711018,"(37.5, 52.0]",Q3
36085,2020-03-23,476179,40,200,915,487,2488,126.28571428571429,26.520639147403454,"(37.5, 52.0]",Q3
36085,2020-03-24,476179,40,110,1025,223,2711,138.28571428571428,29.04069988086713,"(37.5, 52.0]",Q3
36085,2020-03-25,476179,40,164,1189,293,3004,157.0,32.970794596149766,"(37.5, 52.0]",Q3
36085,2020-03-26,476179,40,223,1412,413,3417,172.28571428571428,36.18087195901421,"(37.5, 52.0]",Q3
36085,2020-03-27,476179,40,415,1827,847,4264,216.0,45.361093202346176,"(37.5, 52.0]",Q3
36085,2020-03-28,476179,40,402,2229,878,5142,243.85714285714286,51.211234190743994,"(37.5, 52.0]",Q3
36085,2020-03-29,476179,40,336,2565,711,5853,264.2857142857143,55.501337582235735,"(37.5, 52.0]",Q3
36085,2020-03-30,476179,40,324,2889,691,6544,282.0,59.221427236396394,"(37.5, 52.0]",Q3
36085,2020-03-31,476179,40,299,3188,616,7160,309.0,64.89156388668967,"(37.5, 52.0]",Q3
36085,2020-04-01,476179,40,279,3467,559,7719,325.42857142857144,68.34164703369352,"(37.5, 52.0]",Q3
36085,2020-04-02,476179,40,287,3754,563,8282,334.57142857142856,70.26169330680868,"(37.5, 52.0]",Q3
36085,2020-04-03,476179,40,319,4073,679,8961,320.85714285714283,67.38162389713591,"(37.5, 52.0]",Q3
36085,2020-04-04,476179,40,218,4291,513,9474,294.57142857142856,61.861490861929774,"(37.5, 52.0]",Q3
36085,2020-04-05,476179,40,288,4579,600,10074,287.7142857142857,60.42145615709339,"(37.5, 52.0]",Q3
36085,2020-04-06,476179,40,218,4797,605,10679,272.57142857142856,57.24137951724636,"(37.5, 52.0]",Q3
36085,2020-04-07,476179,40,546,5343,1262,11941,307.85714285714283,64.65155810255027,"(37.5, 52.0]",Q3
36085,2020-04-08,476179,40,641,5984,1528,13469,359.57142857142856,75.51181983485802,"(37.5, 52.0]",Q3
36085,2020-04-09,476179,40,500,6484,1212,14681,390.0,81.90197383756949,"(37.5, 52.0]",Q3
36085,2020-04-10,476179,40,376,6860,807,15488,398.14285714285717,83.6120150495627,"(37.5, 52.0]",Q3
36085,2020-04-11,476179,40,456,7316,1030,16518,432.14285714285717,90.75218712770977,"(37.5, 52.0]",Q3
36085,2020-04-12,476179,40,352,7668,887,17405,441.2857142857143,92.67223340082496,"(37.5, 52.0]",Q3
36085,2020-04-13,476179,40,292,7960,725,18130,451.85714285714283,94.89228690411439,"(37.5, 52.0]",Q3
36085,2020-04-14,476179,40,338,8298,743,18873,422.14285714285717,88.65213651649005,"(37.5, 52.0]",Q3
36085,2020-04-15,476179,40,386,8684,1184,20057,385.7142857142857,81.00195214704674,"(37.5, 52.0]",Q3
36085,2020-04-16,476179,40,347,9031,1084,21141,363.85714285714283,76.41184152538075,"(37.5, 52.0]",Q3
36085,2020-04-17,476179,40,302,9333,1106,22247,353.2857142857143,74.19178802209133,"(37.5, 52.0]",Q3
36085,2020-04-18,476179,40,341,9674,1288,23535,336.85714285714283,70.74170487508749,"(37.5, 52.0]",Q3
36085,2020-04-19,476179,40,239,9913,874,24409,320.7142857142857,67.3516231741185,"(37.5, 52.0]",Q3
36085,2020-04-20,476179,40,208,10121,882,25291,308.7142857142857,64.83156244065482,"(37.5, 52.0]",Q3
36085,2020-04-21,476179,40,224,10345,998,26289,292.42857142857144,61.4114800166684,"(37.5, 52.0]",Q3
36085,2020-04-22,476179,40,245,10590,1031,27320,272.2857142857143,57.18137807121152,"(37.5, 52.0]",Q3
36085,2020-04-23,476179,40,293,10883,1272,28592,264.57142857142856,55.56133902827058,"(37.5, 52.0]",Q3
36085,2020-04-24,476179,40,246,11129,1011,29603,256.57142857142856,53.8812985392948,"(37.5, 52.0]",Q3
36085,2020-04-25,476179,40,154,11283,882,30485,229.85714285714286,48.27116333503637,"(37.5, 52.0]",Q3
36085,2020-04-26,476179,40,140,11423,658,31143,215.71428571428572,45.30109175631133,"(37.5, 52.0]",Q3
36085,2020-04-27,476179,40,93,11516,567,31710,199.28571428571428,41.85100860930748,"(37.5, 52.0]",Q3
36085,2020-04-28,476179,40,144,11660,935,32645,187.85714285714286,39.45095076791351,"(37.5, 52.0]",Q3
36085,2020-04-29,476179,40,151,11811,841,33486,174.42857142857142,36.63088280427558,"(37.5, 52.0]",Q3
36085,2020-04-30,476179,40,126,11937,849,34335,150.57142857142858,31.620762060365657,"(37.5, 52.0]",Q3
36085,2020-05-01,476179,40,157,12094,918,35253,137.85714285714286,28.950697711814858,"(37.5, 52.0]",Q3
36085,2020-05-02,476179,40,101,12195,729,35982,130.28571428571428,27.360659391891343,"(37.5, 52.0]",Q3
36085,2020-05-03,476179,40,60,12255,549,36531,118.85714285714286,24.96060155049737,"(37.5, 52.0]",Q3
36085,2020-05-04,476179,40,62,12317,573,37104,114.42857142857143,24.0305791369572,"(37.5, 52.0]",Q3
36085,2020-05-05,476179,40,84,12401,702,37806,105.85714285714286,22.23053575591172,"(37.5, 52.0]",Q3
36085,2020-05-06,476179,40,105,12506,828,38634,99.28571428571429,20.85050249711018,"(37.5, 52.0]",Q3
36085,2020-05-07,476179,40,72,12578,672,39306,91.57142857142857,19.230463454169247,"(37.5, 52.0]",Q3
36085,2020-05-08,476179,40,72,12650,832,40138,79.42857142857143,16.680401997688143,"(37.5, 52.0]",Q3
36085,2020-05-09,476179,40,52,12702,717,40855,72.42857142857143,15.210366569834333,"(37.5, 52.0]",Q3
36085,2020-05-10,476179,40,45,12747,493,41348,70.28571428571429,14.760355724572962,"(37.5, 52.0]",Q3
36085,2020-05-11,476179,40,22,12769,517,41865,64.57142857142857,13.560326803875974,"(37.5, 52.0]",Q3
36085,2020-05-12,476179,40,41,12810,806,42671,58.42857142857143,12.27029571412671,"(37.5, 52.0]",Q3
36085,2020-05-13,476179,40,51,12861,869,43540,50.714285714285715,10.650256671185776,"(37.5, 52.0]",Q3
36085,2020-05-14,476179,40,48,12909,812,44352,47.285714285714285,9.930239318767581,"(37.5, 52.0]",Q3
36085,2020-05-15,476179,40,65,12974,843,45195,46.285714285714285,9.72023425764561,"(37.5, 52.0]",Q3
36085,2020-05-16,476179,40,37,13011,713,45908,44.142857142857146,9.270223412384238,"(37.5, 52.0]",Q3
36085,2020-05-17,476179,40,36,13047,571,46479,42.857142857142854,9.000216905227415,"(37.5, 52.0]",Q3
36085,2020-05-18,476179,40,22,13069,621,47100,42.857142857142854,9.000216905227415,"(37.5, 52.0]",Q3
36085,2020-05-19,476179,40,31,13100,751,47851,41.42857142857143,8.70020967505317,"(37.5, 52.0]",Q3
36085,2020-05-20,476179,40,40,13140,908,48759,39.857142857142854,8.370201721861497,"(37.5, 52.0]",Q3
36085,2020-05-21,476179,40,31,13171,877,49636,37.42857142857143,7.860189430565277,"(37.5, 52.0]",Q3
36085,2020-05-22,476179,40,44,13215,1232,50868,34.42857142857143,7.230174247199358,"(37.5, 52.0]",Q3
36085,2020-05-23,476179,40,51,13266,1120,51988,36.42857142857143,7.650184369443304,"(37.5, 52.0]",Q3
36085,2020-05-24,476179,40,21,13287,732,52720,34.285714285714285,7.200173524181932,"(37.5, 52.0]",Q3
36085,2020-05-25,476179,40,38,13325,1047,53767,36.57142857142857,7.680185092460728,"(37.5, 52.0]",Q3
36085,2020-05-26,476179,40,23,13348,720,54487,35.42857142857143,7.440179308321332,"(37.5, 52.0]",Q3
36085,2020-05-27,476179,40,56,13404,1623,56110,37.714285714285715,7.9201908766001266,"(37.5, 52.0]",Q3
36085,2020-05-28,476179,40,51,13455,1731,57841,40.57142857142857,8.52020533694862,"(37.5, 52.0]",Q3
36085,2020-05-29,476179,40,50,13505,1376,59217,41.42857142857143,8.70020967505317,"(37.5, 52.0]",Q3
36085,2020-05-30,476179,40,17,13522,1214,60431,36.57142857142857,7.680185092460728,"(37.5, 52.0]",Q3
36085,2020-05-31,476179,40,15,13537,1200,61631,35.714285714285715,7.5001807543561805,"(37.5, 52.0]",Q3
36085,2020-06-01,476179,40,25,13562,972,62603,33.857142857142854,7.1101713551296575,"(37.5, 52.0]",Q3
36085,2020-06-02,476179,40,23,13585,991,63594,33.857142857142854,7.1101713551296575,"(37.5, 52.0]",Q3
36085,2020-06-03,476179,40,36,13621,1784,65378,31.0,6.510156894781165,"(37.5, 52.0]",Q3
36085,2020-06-04,476179,40,42,13663,1576,66954,29.714285714285715,6.240150387624342,"(37.5, 52.0]",Q3
36085,2020-06-05,476179,40,28,13691,1886,68840,26.571428571428573,5.580134481240998,"(37.5, 52.0]",Q3
36085,2020-06-06,476179,40,26,13717,1379,70219,27.857142857142858,5.850140988397821,"(37.5, 52.0]",Q3
36085,2020-06-07,476179,40,10,13727,1182,71401,27.142857142857142,5.700137373310697,"(37.5, 52.0]",Q3
36087,2020-03-02,325695,43,0,0,0,0,0.0,0.0,"(37.5, 52.0]",Q3
36087,2020-03-03,325695,43,0,0,0,0,0.0,0.0,"(37.5, 52.0]",Q3
36087,2020-03-04,325695,43,0,0,0,0,0.0,0.0,"(37.5, 52.0]",Q3
36087,2020-03-05,325695,43,0,0,0,0,0.0,0.0,"(37.5, 52.0]",Q3
36087,2020-03-06,325695,43,1,1,1,1,1.0,0.3070357236064416,"(37.5, 52.0]",Q3
36087,2020-03-07,325695,43,0,1,0,1,0.0,0.0,"(37.5, 52.0]",Q3
36087,2020-03-08,325695,43,0,1,2,3,0.14285714285714285,0.043862246229491655,"(37.5, 52.0]",Q3
36087,2020-03-09,325695,43,3,4,7,10,0.5714285714285714,0.17544898491796662,"(37.5, 52.0]",Q3
36087,2020-03-10,325695,43,0,4,2,12,0.5714285714285714,0.17544898491796662,"(37.5, 52.0]",Q3
36087,2020-03-11,325695,43,2,6,2,14,0.8571428571428571,0.26317347737694996,"(37.5, 52.0]",Q3
36087,2020-03-12,325695,43,2,8,5,19,1.1428571428571428,0.35089796983593324,"(37.5, 52.0]",Q3
36087,2020-03-13,325695,43,1,9,8,27,1.1428571428571428,0.35089796983593324,"(37.5, 52.0]",Q3
36087,2020-03-14,325695,43,3,12,21,48,1.5714285714285714,0.4824847085244082,"(37.5, 52.0]",Q3
36087,2020-03-15,325695,43,1,13,35,83,1.7142857142857142,0.5263469547538999,"(37.5, 52.0]",Q3
36087,2020-03-16,325695,43,9,22,39,122,2.5714285714285716,0.7895204321308499,"(37.5, 52.0]",Q3
36087,2020-03-17,325695,43,8,30,29,151,3.7142857142857144,1.1404184019667831,"(37.5, 52.0]",Q3
36087,2020-03-18,325695,43,23,53,58,209,6.714285714285714,2.061525572786108,"(37.5, 52.0]",Q3
36087,2020-03-19,325695,43,48,101,192,401,13.285714285714286,4.079188899342724,"(37.5, 52.0]",Q3
36087,2020-03-20,325695,43,161,262,569,970,36.142857142857146,11.09714829606139,"(37.5, 52.0]",Q3
36087,2020-03-21,325695,43,193,455,604,1574,63.285714285714285,19.430975079664805,"(37.5, 52.0]",Q3
36087,2020-03-22,325695,43,137,592,393,1967,82.71428571428571,25.396240566875665,"(37.5, 52.0]",Q3
36087,2020-03-23,325695,43,79,671,315,2282,92.71428571428571,28.466597802940083,"(37.5, 52.0]",Q3
36087,2020-03-24,325695,43,297,968,592,2874,134.0,41.14278696326318,"(37.5, 52.0]",Q3
36087,2020-03-25,325695,43,229,1197,567,3441,163.42857142857142,50.17840968653845,"(37.5, 52.0]",Q3
36087,2020-03-26,325695,43,260,1457,588,4029,193.71428571428572,59.47720588719069,"(37.5, 52.0]",Q3
36087,2020-03-27,325695,43,439,1896,1078,5107,233.42857142857142,71.67091033898937,"(37.5, 52.0]",Q3
36087,2020-03-28,325695,43,313,2209,827,5934,250.57142857142858,76.93437988652838,"(37.5, 52.0]",Q3
36087,2020-03-29,325695,43,302,2511,604,6538,274.14285714285717,84.1716505143945,"(37.5, 52.0]",Q3
36087,2020-03-30,325695,43,352,2863,739,7277,313.14285714285717,96.14604373504572,"(37.5, 52.0]",Q3
36087,2020-03-31,325695,43,458,3321,930,8207,336.14285714285717,103.20786537799388,"(37.5, 52.0]",Q3
36087,2020-04-01,325695,43,430,3751,904,9111,364.85714285714283,112.02417687012169,"(37.5, 52.0]",Q3
36087,2020-04-02,325695,43,538,4289,997,10108,404.57142857142856,124.21788132192039,"(37.5, 52.0]",Q3
36087,2020-04-03,325695,43,583,4872,1124,11232,425.14285714285717,130.53404477896717,"(37.5, 52.0]",Q3
36087,2020-04-04,325695,43,454,5326,880,12112,445.2857142857143,136.7186214973255,"(37.5, 52.0]",Q3
36087,2020-04-05,325695,43,377,5703,732,12844,456.0,140.00828996453737,"(37.5, 52.0]",Q3
36087,2020-04-06,325695,43,287,5990,662,13506,446.7142857142857,137.15724395962042,"(37.5, 52.0]",Q3
36087,2020-04-07,325695,43,423,6413,1027,14533,441.7142857142857,135.6220653415882,"(37.5, 52.0]",Q3
36087,2020-04-08,325695,43,252,6665,648,15181,416.2857142857143,127.81458551273869,"(37.5, 52.0]",Q3
36087,2020-04-09,325695,43,457,7122,1013,16194,404.7142857142857,124.26174356814988,"(37.5, 52.0]",Q3
36087,2020-04-10,325695,43,355,7477,785,16979,372.14285714285717,114.26115142782578,"(37.5, 52.0]",Q3
36087,2020-04-11,325695,43,244,7721,569,17548,342.14285714285717,105.05007971963252,"(37.5, 52.0]",Q3
36087,2020-04-12,325695,43,244,7965,586,18134,323.14285714285717,99.21640097111013,"(37.5, 52.0]",Q3
36087,2020-04-13,325695,43,370,8335,779,18913,335.0,102.85696740815794,"(37.5, 52.0]",Q3
36087,2020-04-14,325695,43,139,8474,371,19284,294.42857142857144,90.40008947898231,"(37.5, 52.0]",Q3
36087,2020-04-15,325695,43,278,8752,830,20114,298.14285714285717,91.5405078809491,"(37.5, 52.0]",Q3
36087,2020-04-16,325695,43,235,8987,678,20792,266.42857142857144,81.80308921800194,"(37.5, 52.0]",Q3
36087,2020-04-17,325695,43,184,9171,610,21402,242.0,74.30264511275887,"(37.5, 52.0]",Q3
36087,2020-04-18,325695,43,193,9364,547,21949,234.71428571428572,72.0656705550548,"(37.5, 52.0]",Q3
36087,2020-04-19,325695,43,93,9457,316,22265,213.14285714285714,65.44247137440155,"(37.5, 52.0]",Q3
36087,2020-04-20,325695,43,111,9568,407,22672,176.14285714285714,54.08214960096321,"(37.5, 52.0]",Q3
36087,2020-04-21,325695,43,131,9699,478,23150,175.0,53.73125163112728,"(37.5, 52.0]",Q3
36087,2020-04-22,325695,43,129,9828,584,23734,153.71428571428572,47.19577694293302,"(37.5, 52.0]",Q3
36087,2020-04-23,325695,43,263,10091,1255,24989,157.71428571428572,48.423919837358795,"(37.5, 52.0]",Q3
36087,2020-04-24,325695,43,1000,11091,2606,27595,274.2857142857143,84.21551276062398,"(37.5, 52.0]",Q3
36087,2020-04-25,325695,43,165,11256,677,28272,270.2857142857143,82.98736986619822,"(37.5, 52.0]",Q3
36087,2020-04-26,325695,43,110,11366,565,28837,272.7142857142857,83.73302805209958,"(37.5, 52.0]",Q3
36087,2020-04-27,325695,43,87,11453,537,29374,269.2857142857143,82.68033414259178,"(37.5, 52.0]",Q3
36087,2020-04-28,325695,43,133,11586,528,29902,269.57142857142856,82.76805863505075,"(37.5, 52.0]",Q3
36087,2020-04-29,325695,43,122,11708,691,30593,268.57142857142856,82.46102291144432,"(37.5, 52.0]",Q3
36087,2020-04-30,325695,43,104,11812,823,31416,245.85714285714286,75.48692576095515,"(37.5, 52.0]",Q3
36087,2020-05-01,325695,43,133,11945,779,32195,122.0,37.45835827998588,"(37.5, 52.0]",Q3
36087,2020-05-02,325695,43,80,12025,598,32793,109.85714285714286,33.73006735047908,"(37.5, 52.0]",Q3
36087,2020-05-03,325695,43,70,12095,476,33269,104.14285714285714,31.975577501299416,"(37.5, 52.0]",Q3
36087,2020-05-04,325695,43,49,12144,437,33706,98.71428571428571,30.30881214457873,"(37.5, 52.0]",Q3
36087,2020-05-05,325695,43,60,12204,401,34107,88.28571428571429,27.106868169825844,"(37.5, 52.0]",Q3
36087,2020-05-06,325695,43,76,12280,852,34959,81.71428571428571,25.089204843269226,"(37.5, 52.0]",Q3
36087,2020-05-07,325695,43,69,12349,740,35699,76.71428571428571,23.55402622523702,"(37.5, 52.0]",Q3
36087,2020-05-08,325695,43,51,12400,669,36368,65.0,19.957322034418706,"(37.5, 52.0]",Q3
36087,2020-05-09,325695,43,51,12451,582,36950,60.857142857142854,18.685316893763446,"(37.5, 52.0]",Q3
36087,2020-05-10,325695,43,33,12484,564,37514,55.57142857142857,17.062413783272255,"(37.5, 52.0]",Q3
36087,2020-05-11,325695,43,20,12504,368,37882,51.42857142857143,15.790408642616999,"(37.5, 52.0]",Q3
36087,2020-05-12,325695,43,39,12543,637,38519,48.42857142857143,14.869301471797673,"(37.5, 52.0]",Q3
36087,2020-05-13,325695,43,53,12596,1096,39615,45.142857142857146,13.860469808519364,"(37.5, 52.0]",Q3
36087,2020-05-14,325695,43,41,12637,851,40466,41.142857142857146,12.632326914093598,"(37.5, 52.0]",Q3
36087,2020-05-15,325695,43,51,12688,1035,41501,41.142857142857146,12.632326914093598,"(37.5, 52.0]",Q3
36087,2020-05-16,325695,43,70,12758,779,42280,43.857142857142854,13.465709592453939,"(37.5, 52.0]",Q3
36087,2020-05-17,325695,43,19,12777,486,42766,41.857142857142854,12.851638145241056,"(37.5, 52.0]",Q3
36087,2020-05-18,325695,43,21,12798,338,43104,42.0,12.895500391470549,"(37.5, 52.0]",Q3
36087,2020-05-19,325695,43,33,12831,577,43681,41.142857142857146,12.632326914093598,"(37.5, 52.0]",Q3
36087,2020-05-20,325695,43,46,12877,1091,44772,40.142857142857146,12.325291190487157,"(37.5, 52.0]",Q3
36087,2020-05-21,325695,43,28,12905,790,45562,38.285714285714285,11.755081989503765,"(37.5, 52.0]",Q3
36087,2020-05-22,325695,43,29,12934,814,46376,35.142857142857146,10.790112572454948,"(37.5, 52.0]",Q3
36087,2020-05-23,325695,43,29,12963,735,47111,29.285714285714285,8.99176047704579,"(37.5, 52.0]",Q3
36087,2020-05-24,325695,43,33,12996,634,47745,31.285714285714285,9.605831924258673,"(37.5, 52.0]",Q3
36087,2020-05-25,325695,43,23,13019,652,48397,31.571428571428573,9.693556416717657,"(37.5, 52.0]",Q3
36087,2020-05-26,325695,43,28,13047,554,48951,30.857142857142858,9.474245185570197,"(37.5, 52.0]",Q3
36087,2020-05-27,325695,43,29,13076,1115,50066,28.428571428571427,8.72858699966884,"(37.5, 52.0]",Q3
36087,2020-05-28,325695,43,24,13100,1097,51163,27.857142857142858,8.553138014750873,"(37.5, 52.0]",Q3
36087,2020-05-29,325695,43,28,13128,807,51970,27.714285714285715,8.509275768521382,"(37.5, 52.0]",Q3
36087,2020-05-30,325695,43,23,13151,616,52586,26.857142857142858,8.246102291144432,"(37.5, 52.0]",Q3
36087,2020-05-31,325695,43,34,13185,682,53268,27.0,8.289964537373924,"(37.5, 52.0]",Q3
36087,2020-06-01,325695,43,38,13223,785,54053,29.142857142857142,8.947898230816298,"(37.5, 52.0]",Q3
36087,2020-06-02,325695,43,36,13259,1088,55141,30.285714285714285,9.298796200652232,"(37.5, 52.0]",Q3
36087,2020-06-03,325695,43,21,13280,969,56110,29.142857142857142,8.947898230816298,"(37.5, 52.0]",Q3
36087,2020-06-04,325695,43,17,13297,1191,57301,28.142857142857142,8.640862507209857,"(37.5, 52.0]",Q3
36087,2020-06-05,325695,43,18,13315,1030,58331,26.714285714285715,8.20224004491494,"(37.5, 52.0]",Q3
36087,2020-06-06,325695,43,10,13325,795,59126,24.857142857142858,7.632030843931548,"(37.5, 52.0]",Q3
36087,2020-06-07,325695,43,15,13340,761,59887,22.142857142857142,6.7986481655712065,"(37.5, 52.0]",Q3
36089,2020-03-02,108047,58,0,0,0,0,0.0,0.0,"(52.0, 100.0]",Q4
36089,2020-03-03,108047,58,0,0,0,0,0.0,0.0,"(52.0, 100.0]",Q4
36089,2020-03-04,108047,58,0,0,0,0,0.0,0.0,"(52.0, 100.0]",Q4
36089,2020-03-05,108047,58,0,0,0,0,0.0,0.0,"(52.0, 100.0]",Q4
36089,2020-03-06,108047,58,0,0,0,0,0.0,0.0,"(52.0, 100.0]",Q4
36089,2020-03-07,108047,58,0,0,2,2,0.0,0.0,"(52.0, 100.0]",Q4
36089,2020-03-08,108047,58,0,0,0,2,0.0,0.0,"(52.0, 100.0]",Q4
36089,2020-03-09,108047,58,0,0,0,2,0.0,0.0,"(52.0, 100.0]",Q4
36089,2020-03-10,108047,58,0,0,1,3,0.0,0.0,"(52.0, 100.0]",Q4
36089,2020-03-11,108047,58,0,0,2,5,0.0,0.0,"(52.0, 100.0]",Q4
36089,2020-03-12,108047,58,0,0,1,6,0.0,0.0,"(52.0, 100.0]",Q4
36089,2020-03-13,108047,58,0,0,1,7,0.0,0.0,"(52.0, 100.0]",Q4
36089,2020-03-14,108047,58,0,0,1,8,0.0,0.0,"(52.0, 100.0]",Q4
36089,2020-03-15,108047,58,0,0,1,9,0.0,0.0,"(52.0, 100.0]",Q4
36089,2020-03-16,108047,58,0,0,0,9,0.0,0.0,"(52.0, 100.0]",Q4
36089,2020-03-17,108047,58,0,0,7,16,0.0,0.0,"(52.0, 100.0]",Q4
36089,2020-03-18,108047,58,0,0,3,19,0.0,0.0,"(52.0, 100.0]",Q4
36089,2020-03-19,108047,58,0,0,7,26,0.0,0.0,"(52.0, 100.0]",Q4
36089,2020-03-20,108047,58,0,0,7,33,0.0,0.0,"(52.0, 100.0]",Q4
36089,2020-03-21,108047,58,1,1,20,53,0.14285714285714285,0.13221759313737805,"(52.0, 100.0]",Q4
36089,2020-03-22,108047,58,0,1,9,62,0.14285714285714285,0.13221759313737805,"(52.0, 100.0]",Q4
36089,2020-03-23,108047,58,0,1,6,68,0.14285714285714285,0.13221759313737805,"(52.0, 100.0]",Q4
36089,2020-03-24,108047,58,0,1,10,78,0.14285714285714285,0.13221759313737805,"(52.0, 100.0]",Q4
36089,2020-03-25,108047,58,1,2,14,92,0.2857142857142857,0.2644351862747561,"(52.0, 100.0]",Q4
36089,2020-03-26,108047,58,1,3,29,121,0.42857142857142855,0.39665277941213417,"(52.0, 100.0]",Q4
36089,2020-03-27,108047,58,5,8,82,203,1.1428571428571428,1.0577407450990244,"(52.0, 100.0]",Q4
36089,2020-03-28,108047,58,4,12,65,268,1.5714285714285714,1.4543935245111583,"(52.0, 100.0]",Q4
36089,2020-03-29,108047,58,1,13,44,312,1.7142857142857142,1.5866111176485367,"(52.0, 100.0]",Q4
36089,2020-03-30,108047,58,17,30,74,386,4.142857142857143,3.8343102009839636,"(52.0, 100.0]",Q4
36089,2020-03-31,108047,58,4,34,32,418,4.714285714285714,4.363180573533476,"(52.0, 100.0]",Q4
36089,2020-04-01,108047,58,5,39,30,448,5.285714285714286,4.892050946082988,"(52.0, 100.0]",Q4
36089,2020-04-02,108047,58,4,43,54,502,5.714285714285714,5.288703725495122,"(52.0, 100.0]",Q4
36089,2020-04-03,108047,58,9,52,81,583,6.285714285714286,5.817574098044633,"(52.0, 100.0]",Q4
36089,2020-04-04,108047,58,3,55,46,629,6.142857142857143,5.685356504907256,"(52.0, 100.0]",Q4
36089,2020-04-05,108047,58,4,59,43,672,6.571428571428571,6.08200928431939,"(52.0, 100.0]",Q4
36089,2020-04-06,108047,58,1,60,64,736,4.285714285714286,3.9665277941213413,"(52.0, 100.0]",Q4
36089,2020-04-07,108047,58,9,69,69,805,5.0,4.627615759808232,"(52.0, 100.0]",Q4
36089,2020-04-08,108047,58,7,76,50,855,5.285714285714286,4.892050946082988,"(52.0, 100.0]",Q4
36089,2020-04-09,108047,58,2,78,24,879,5.0,4.627615759808232,"(52.0, 100.0]",Q4
36089,2020-04-10,108047,58,2,80,19,898,4.0,3.7020926078465854,"(52.0, 100.0]",Q4
36089,2020-04-11,108047,58,5,85,65,963,4.285714285714286,3.9665277941213413,"(52.0, 100.0]",Q4
36089,2020-04-12,108047,58,4,89,47,1010,4.285714285714286,3.9665277941213413,"(52.0, 100.0]",Q4
36089,2020-04-13,108047,58,3,92,29,1039,4.571428571428571,4.2309629803960975,"(52.0, 100.0]",Q4
36089,2020-04-14,108047,58,0,92,7,1046,3.2857142857142856,3.041004642159695,"(52.0, 100.0]",Q4
36089,2020-04-15,108047,58,1,93,48,1094,2.4285714285714284,2.247699083335427,"(52.0, 100.0]",Q4
36089,2020-04-16,108047,58,3,96,16,1110,2.5714285714285716,2.379916676472805,"(52.0, 100.0]",Q4
36089,2020-04-17,108047,58,2,98,6,1116,2.5714285714285716,2.379916676472805,"(52.0, 100.0]",Q4
36089,2020-04-18,108047,58,7,105,25,1141,2.857142857142857,2.644351862747561,"(52.0, 100.0]",Q4
36089,2020-04-19,108047,58,5,110,24,1165,3.0,2.776569455884939,"(52.0, 100.0]",Q4
36089,2020-04-20,108047,58,10,120,17,1182,4.0,3.7020926078465854,"(52.0, 100.0]",Q4
36089,2020-04-21,108047,58,3,123,6,1188,4.428571428571429,4.098745387258719,"(52.0, 100.0]",Q4
36089,2020-04-22,108047,58,16,139,94,1282,6.571428571428571,6.08200928431939,"(52.0, 100.0]",Q4
36089,2020-04-23,108047,58,5,144,37,1319,6.857142857142857,6.346444470594147,"(52.0, 100.0]",Q4
36089,2020-04-24,108047,58,12,156,64,1383,8.285714285714286,7.668620401967927,"(52.0, 100.0]",Q4
36089,2020-04-25,108047,58,11,167,36,1419,8.857142857142858,8.197490774517439,"(52.0, 100.0]",Q4
36089,2020-04-26,108047,58,2,169,27,1446,8.428571428571429,7.800837995105304,"(52.0, 100.0]",Q4
36089,2020-04-27,108047,58,1,170,19,1465,7.142857142857143,6.610879656868903,"(52.0, 100.0]",Q4
36089,2020-04-28,108047,58,0,170,84,1549,6.714285714285714,6.214226877456768,"(52.0, 100.0]",Q4
36089,2020-04-29,108047,58,3,173,277,1826,4.857142857142857,4.495398166670854,"(52.0, 100.0]",Q4
36089,2020-04-30,108047,58,3,176,157,1983,4.571428571428571,4.2309629803960975,"(52.0, 100.0]",Q4
36089,2020-05-01,108047,58,0,176,130,2113,2.857142857142857,2.644351862747561,"(52.0, 100.0]",Q4
36089,2020-05-02,108047,58,1,177,125,2238,1.4285714285714286,1.3221759313737804,"(52.0, 100.0]",Q4
36089,2020-05-03,108047,58,1,178,85,2323,1.2857142857142858,1.1899583382364025,"(52.0, 100.0]",Q4
36089,2020-05-04,108047,58,0,178,38,2361,1.1428571428571428,1.0577407450990244,"(52.0, 100.0]",Q4
36089,2020-05-05,108047,58,2,180,34,2395,1.4285714285714286,1.3221759313737804,"(52.0, 100.0]",Q4
36089,2020-05-06,108047,58,1,181,53,2448,1.1428571428571428,1.0577407450990244,"(52.0, 100.0]",Q4
36089,2020-05-07,108047,58,6,187,845,3293,1.5714285714285714,1.4543935245111583,"(52.0, 100.0]",Q4
36089,2020-05-08,108047,58,0,187,164,3457,1.5714285714285714,1.4543935245111583,"(52.0, 100.0]",Q4
36089,2020-05-09,108047,58,0,187,51,3508,1.4285714285714286,1.3221759313737804,"(52.0, 100.0]",Q4
36089,2020-05-10,108047,58,3,190,47,3555,1.7142857142857142,1.5866111176485367,"(52.0, 100.0]",Q4
36089,2020-05-11,108047,58,1,191,18,3573,1.8571428571428572,1.7188287107859146,"(52.0, 100.0]",Q4
36089,2020-05-12,108047,58,1,192,151,3724,1.7142857142857142,1.5866111176485367,"(52.0, 100.0]",Q4
36089,2020-05-13,108047,58,0,192,105,3829,1.5714285714285714,1.4543935245111583,"(52.0, 100.0]",Q4
36089,2020-05-14,108047,58,0,192,332,4161,0.7142857142857143,0.6610879656868902,"(52.0, 100.0]",Q4
36089,2020-05-15,108047,58,0,192,1456,5617,0.7142857142857143,0.6610879656868902,"(52.0, 100.0]",Q4
36089,2020-05-16,108047,58,0,192,205,5822,0.7142857142857143,0.6610879656868902,"(52.0, 100.0]",Q4
36089,2020-05-17,108047,58,0,192,239,6061,0.2857142857142857,0.2644351862747561,"(52.0, 100.0]",Q4
36089,2020-05-18,108047,58,0,192,71,6132,0.14285714285714285,0.13221759313737805,"(52.0, 100.0]",Q4
36089,2020-05-19,108047,58,3,195,173,6305,0.42857142857142855,0.39665277941213417,"(52.0, 100.0]",Q4
36089,2020-05-20,108047,58,0,195,504,6809,0.42857142857142855,0.39665277941213417,"(52.0, 100.0]",Q4
36089,2020-05-21,108047,58,0,195,349,7158,0.42857142857142855,0.39665277941213417,"(52.0, 100.0]",Q4
36089,2020-05-22,108047,58,1,196,333,7491,0.5714285714285714,0.5288703725495122,"(52.0, 100.0]",Q4
36089,2020-05-23,108047,58,1,197,301,7792,0.7142857142857143,0.6610879656868902,"(52.0, 100.0]",Q4
36089,2020-05-24,108047,58,0,197,114,7906,0.7142857142857143,0.6610879656868902,"(52.0, 100.0]",Q4
36089,2020-05-25,108047,58,0,197,60,7966,0.7142857142857143,0.6610879656868902,"(52.0, 100.0]",Q4
36089,2020-05-26,108047,58,3,200,78,8044,0.7142857142857143,0.6610879656868902,"(52.0, 100.0]",Q4
36089,2020-05-27,108047,58,1,201,227,8271,0.8571428571428571,0.7933055588242683,"(52.0, 100.0]",Q4
36089,2020-05-28,108047,58,1,202,447,8718,1.0,0.9255231519616464,"(52.0, 100.0]",Q4
36089,2020-05-29,108047,58,0,202,136,8854,0.8571428571428571,0.7933055588242683,"(52.0, 100.0]",Q4
36089,2020-05-30,108047,58,2,204,303,9157,1.0,0.9255231519616464,"(52.0, 100.0]",Q4
36089,2020-05-31,108047,58,1,205,472,9629,1.1428571428571428,1.0577407450990244,"(52.0, 100.0]",Q4
36089,2020-06-01,108047,58,0,205,106,9735,1.1428571428571428,1.0577407450990244,"(52.0, 100.0]",Q4
36089,2020-06-02,108047,58,1,206,324,10059,0.8571428571428571,0.7933055588242683,"(52.0, 100.0]",Q4
36089,2020-06-03,108047,58,1,207,293,10352,0.8571428571428571,0.7933055588242683,"(52.0, 100.0]",Q4
36089,2020-06-04,108047,58,0,207,451,10803,0.7142857142857143,0.6610879656868902,"(52.0, 100.0]",Q4
36089,2020-06-05,108047,58,2,209,477,11280,1.0,0.9255231519616464,"(52.0, 100.0]",Q4
36089,2020-06-06,108047,58,0,209,382,11662,0.7142857142857143,0.6610879656868902,"(52.0, 100.0]",Q4
36089,2020-06-07,108047,58,0,209,539,12201,0.5714285714285714,0.5288703725495122,"(52.0, 100.0]",Q4
36091,2020-03-02,230163,4,0,0,0,0,0.0,0.0,"(3.999, 24.0]",Q1
36091,2020-03-03,230163,4,0,0,0,0,0.0,0.0,"(3.999, 24.0]",Q1
36091,2020-03-04,230163,4,0,0,0,0,0.0,0.0,"(3.999, 24.0]",Q1
36091,2020-03-05,230163,4,0,0,0,0,0.0,0.0,"(3.999, 24.0]",Q1
36091,2020-03-06,230163,4,0,0,0,0,0.0,0.0,"(3.999, 24.0]",Q1
36091,2020-03-07,230163,4,0,0,1,1,0.0,0.0,"(3.999, 24.0]",Q1
36091,2020-03-08,230163,4,0,0,0,1,0.0,0.0,"(3.999, 24.0]",Q1
36091,2020-03-09,230163,4,2,2,9,10,0.2857142857142857,0.12413562810455447,"(3.999, 24.0]",Q1
36091,2020-03-10,230163,4,0,2,2,12,0.2857142857142857,0.12413562810455447,"(3.999, 24.0]",Q1
36091,2020-03-11,230163,4,1,3,31,43,0.42857142857142855,0.18620344215683168,"(3.999, 24.0]",Q1
36091,2020-03-12,230163,4,0,3,32,75,0.42857142857142855,0.18620344215683168,"(3.999, 24.0]",Q1
36091,2020-03-13,230163,4,0,3,41,116,0.42857142857142855,0.18620344215683168,"(3.999, 24.0]",Q1
36091,2020-03-14,230163,4,0,3,45,161,0.42857142857142855,0.18620344215683168,"(3.999, 24.0]",Q1
36091,2020-03-15,230163,4,2,5,66,227,0.7142857142857143,0.3103390702613862,"(3.999, 24.0]",Q1
36091,2020-03-16,230163,4,4,9,55,282,1.0,0.43447469836594066,"(3.999, 24.0]",Q1
36091,2020-03-17,230163,4,5,14,76,358,1.7142857142857142,0.7448137686273267,"(3.999, 24.0]",Q1
36091,2020-03-18,230163,4,4,18,156,514,2.142857142857143,0.9310172107841584,"(3.999, 24.0]",Q1
36091,2020-03-19,230163,4,6,24,102,616,3.0,1.303424095097822,"(3.999, 24.0]",Q1
36091,2020-03-20,230163,4,11,35,279,895,4.571428571428571,1.9861700496728716,"(3.999, 24.0]",Q1
36091,2020-03-21,230163,4,6,41,143,1038,5.428571428571429,2.358576933986535,"(3.999, 24.0]",Q1
36091,2020-03-22,230163,4,12,53,164,1202,6.857142857142857,2.979255074509307,"(3.999, 24.0]",Q1
36091,2020-03-23,230163,4,7,60,76,1278,7.285714285714286,3.165458516666139,"(3.999, 24.0]",Q1
36091,2020-03-24,230163,4,4,64,69,1347,7.142857142857143,3.103390702613862,"(3.999, 24.0]",Q1
36091,2020-03-25,230163,4,9,73,55,1402,7.857142857142857,3.4137297728752483,"(3.999, 24.0]",Q1
36091,2020-03-26,230163,4,9,82,69,1471,8.285714285714286,3.59993321503208,"(3.999, 24.0]",Q1
36091,2020-03-27,230163,4,14,96,82,1553,8.714285714285714,3.7861366571889112,"(3.999, 24.0]",Q1
36091,2020-03-28,230163,4,6,102,51,1604,8.714285714285714,3.7861366571889112,"(3.999, 24.0]",Q1
36091,2020-03-29,230163,4,3,105,15,1619,7.428571428571429,3.2275263307184168,"(3.999, 24.0]",Q1
36091,2020-03-30,230163,4,3,108,23,1642,6.857142857142857,2.979255074509307,"(3.999, 24.0]",Q1
36091,2020-03-31,230163,4,14,122,78,1720,8.285714285714286,3.59993321503208,"(3.999, 24.0]",Q1
36091,2020-04-01,230163,4,10,132,69,1789,8.428571428571429,3.6620010290843568,"(3.999, 24.0]",Q1
36091,2020-04-02,230163,4,9,141,53,1842,8.428571428571429,3.6620010290843568,"(3.999, 24.0]",Q1
36091,2020-04-03,230163,4,0,141,57,1899,6.428571428571429,2.793051632352476,"(3.999, 24.0]",Q1
36091,2020-04-04,230163,4,7,148,110,2009,6.571428571428571,2.855119446404753,"(3.999, 24.0]",Q1
36091,2020-04-05,230163,4,5,153,34,2043,6.857142857142857,2.979255074509307,"(3.999, 24.0]",Q1
36091,2020-04-06,230163,4,2,155,40,2083,6.714285714285714,2.9171872604570304,"(3.999, 24.0]",Q1
36091,2020-04-07,230163,4,7,162,73,2156,5.714285714285714,2.4827125620910895,"(3.999, 24.0]",Q1
36091,2020-04-08,230163,4,10,172,113,2269,5.714285714285714,2.4827125620910895,"(3.999, 24.0]",Q1
36091,2020-04-09,230163,4,10,182,154,2423,5.857142857142857,2.5447803761433665,"(3.999, 24.0]",Q1
36091,2020-04-10,230163,4,5,187,68,2491,6.571428571428571,2.855119446404753,"(3.999, 24.0]",Q1
36091,2020-04-11,230163,4,9,196,88,2579,6.857142857142857,2.979255074509307,"(3.999, 24.0]",Q1
36091,2020-04-12,230163,4,5,201,61,2640,6.857142857142857,2.979255074509307,"(3.999, 24.0]",Q1
36091,2020-04-13,230163,4,23,224,193,2833,9.857142857142858,4.28267916960713,"(3.999, 24.0]",Q1
36091,2020-04-14,230163,4,3,227,71,2904,9.285714285714286,4.034407913398021,"(3.999, 24.0]",Q1
36091,2020-04-15,230163,4,4,231,92,2996,8.428571428571429,3.6620010290843568,"(3.999, 24.0]",Q1
36091,2020-04-16,230163,4,5,236,77,3073,7.714285714285714,3.351661958822971,"(3.999, 24.0]",Q1
36091,2020-04-17,230163,4,8,244,98,3171,8.142857142857142,3.5378654009798023,"(3.999, 24.0]",Q1
36091,2020-04-18,230163,4,7,251,105,3276,7.857142857142857,3.4137297728752483,"(3.999, 24.0]",Q1
36091,2020-04-19,230163,4,3,254,32,3308,7.571428571428571,3.2895941447706933,"(3.999, 24.0]",Q1
36091,2020-04-20,230163,4,3,257,42,3350,4.714285714285714,2.0482378637251486,"(3.999, 24.0]",Q1
36091,2020-04-21,230163,4,7,264,101,3451,5.285714285714286,2.2965091199342575,"(3.999, 24.0]",Q1
36091,2020-04-22,230163,4,1,265,52,3503,4.857142857142857,2.110305677777426,"(3.999, 24.0]",Q1
36091,2020-04-23,230163,4,13,278,127,3630,6.0,2.606848190195644,"(3.999, 24.0]",Q1
36091,2020-04-24,230163,4,42,320,642,4272,10.857142857142858,4.71715386797307,"(3.999, 24.0]",Q1
36091,2020-04-25,230163,4,10,330,217,4489,11.285714285714286,4.903357310129902,"(3.999, 24.0]",Q1
36091,2020-04-26,230163,4,6,336,114,4603,11.714285714285714,5.089560752286733,"(3.999, 24.0]",Q1
36091,2020-04-27,230163,4,7,343,116,4719,12.285714285714286,5.337832008495843,"(3.999, 24.0]",Q1
36091,2020-04-28,230163,4,3,346,125,4844,11.714285714285714,5.089560752286733,"(3.999, 24.0]",Q1
36091,2020-04-29,230163,4,8,354,195,5039,12.714285714285714,5.524035450652674,"(3.999, 24.0]",Q1
36091,2020-04-30,230163,4,4,358,171,5210,11.428571428571429,4.965425124182179,"(3.999, 24.0]",Q1
36091,2020-05-01,230163,4,3,361,173,5383,5.857142857142857,2.5447803761433665,"(3.999, 24.0]",Q1
36091,2020-05-02,230163,4,2,363,203,5586,4.714285714285714,2.0482378637251486,"(3.999, 24.0]",Q1
36091,2020-05-03,230163,4,4,367,103,5689,4.428571428571429,1.9241022356205943,"(3.999, 24.0]",Q1
36091,2020-05-04,230163,4,1,368,115,5804,3.5714285714285716,1.551695351306931,"(3.999, 24.0]",Q1
36091,2020-05-05,230163,4,3,371,173,5977,3.5714285714285716,1.551695351306931,"(3.999, 24.0]",Q1
36091,2020-05-06,230163,4,3,374,157,6134,2.857142857142857,1.2413562810455447,"(3.999, 24.0]",Q1
36091,2020-05-07,230163,4,14,388,174,6308,4.285714285714286,1.8620344215683169,"(3.999, 24.0]",Q1
36091,2020-05-08,230163,4,11,399,179,6487,5.428571428571429,2.358576933986535,"(3.999, 24.0]",Q1
36091,2020-05-09,230163,4,3,402,183,6670,5.571428571428571,2.420644748038812,"(3.999, 24.0]",Q1
36091,2020-05-10,230163,4,1,403,170,6840,5.142857142857143,2.2344413058819805,"(3.999, 24.0]",Q1
36091,2020-05-11,230163,4,4,407,154,6994,5.571428571428571,2.420644748038812,"(3.999, 24.0]",Q1
36091,2020-05-12,230163,4,3,410,196,7190,5.571428571428571,2.420644748038812,"(3.999, 24.0]",Q1
36091,2020-05-13,230163,4,5,415,280,7470,5.857142857142857,2.5447803761433665,"(3.999, 24.0]",Q1
36091,2020-05-14,230163,4,6,421,266,7736,4.714285714285714,2.0482378637251486,"(3.999, 24.0]",Q1
36091,2020-05-15,230163,4,2,423,358,8094,3.4285714285714284,1.4896275372546535,"(3.999, 24.0]",Q1
36091,2020-05-16,230163,4,5,428,560,8654,3.7142857142857144,1.6137631653592084,"(3.999, 24.0]",Q1
36091,2020-05-17,230163,4,6,434,242,8896,4.428571428571429,1.9241022356205943,"(3.999, 24.0]",Q1
36091,2020-05-18,230163,4,2,436,139,9035,4.142857142857143,1.79996660751604,"(3.999, 24.0]",Q1
36091,2020-05-19,230163,4,2,438,267,9302,4.0,1.7378987934637626,"(3.999, 24.0]",Q1
36091,2020-05-20,230163,4,2,440,458,9760,3.5714285714285716,1.551695351306931,"(3.999, 24.0]",Q1
36091,2020-05-21,230163,4,8,448,351,10111,3.857142857142857,1.6758309794114854,"(3.999, 24.0]",Q1
36091,2020-05-22,230163,4,4,452,254,10365,4.142857142857143,1.79996660751604,"(3.999, 24.0]",Q1
36091,2020-05-23,230163,4,4,456,316,10681,4.0,1.7378987934637626,"(3.999, 24.0]",Q1
36091,2020-05-24,230163,4,5,461,185,10866,3.857142857142857,1.6758309794114854,"(3.999, 24.0]",Q1
36091,2020-05-25,230163,4,2,463,312,11178,3.857142857142857,1.6758309794114854,"(3.999, 24.0]",Q1
36091,2020-05-26,230163,4,2,465,285,11463,3.857142857142857,1.6758309794114854,"(3.999, 24.0]",Q1
36091,2020-05-27,230163,4,3,468,292,11755,4.0,1.7378987934637626,"(3.999, 24.0]",Q1
36091,2020-05-28,230163,4,5,473,511,12266,3.5714285714285716,1.551695351306931,"(3.999, 24.0]",Q1
36091,2020-05-29,230163,4,4,477,518,12784,3.5714285714285716,1.551695351306931,"(3.999, 24.0]",Q1
36091,2020-05-30,230163,4,3,480,399,13183,3.4285714285714284,1.4896275372546535,"(3.999, 24.0]",Q1
36091,2020-05-31,230163,4,3,483,487,13670,3.142857142857143,1.3654919091500992,"(3.999, 24.0]",Q1
36091,2020-06-01,230163,4,1,484,317,13987,3.0,1.303424095097822,"(3.999, 24.0]",Q1
36091,2020-06-02,230163,4,5,489,609,14596,3.4285714285714284,1.4896275372546535,"(3.999, 24.0]",Q1
36091,2020-06-03,230163,4,4,493,741,15337,3.5714285714285716,1.551695351306931,"(3.999, 24.0]",Q1
36091,2020-06-04,230163,4,3,496,574,15911,3.2857142857142856,1.4275597232023765,"(3.999, 24.0]",Q1
36091,2020-06-05,230163,4,5,501,610,16521,3.4285714285714284,1.4896275372546535,"(3.999, 24.0]",Q1
36091,2020-06-06,230163,4,1,502,520,17041,3.142857142857143,1.3654919091500992,"(3.999, 24.0]",Q1
36091,2020-06-07,230163,4,2,504,654,17695,3.0,1.303424095097822,"(3.999, 24.0]",Q1
36093,2020-03-02,155350,27,0,0,0,0,0.0,0.0,"(24.0, 37.5]",Q2
36093,2020-03-03,155350,27,0,0,0,0,0.0,0.0,"(24.0, 37.5]",Q2
36093,2020-03-04,155350,27,0,0,0,0,0.0,0.0,"(24.0, 37.5]",Q2
36093,2020-03-05,155350,27,0,0,0,0,0.0,0.0,"(24.0, 37.5]",Q2
36093,2020-03-06,155350,27,0,0,0,0,0.0,0.0,"(24.0, 37.5]",Q2
36093,2020-03-07,155350,27,0,0,0,0,0.0,0.0,"(24.0, 37.5]",Q2
36093,2020-03-08,155350,27,0,0,1,1,0.0,0.0,"(24.0, 37.5]",Q2
36093,2020-03-09,155350,27,0,0,2,3,0.0,0.0,"(24.0, 37.5]",Q2
36093,2020-03-10,155350,27,0,0,0,3,0.0,0.0,"(24.0, 37.5]",Q2
36093,2020-03-11,155350,27,0,0,12,15,0.0,0.0,"(24.0, 37.5]",Q2
36093,2020-03-12,155350,27,0,0,5,20,0.0,0.0,"(24.0, 37.5]",Q2
36093,2020-03-13,155350,27,1,1,20,40,0.14285714285714285,0.09195825095406684,"(24.0, 37.5]",Q2
36093,2020-03-14,155350,27,1,2,54,94,0.2857142857142857,0.1839165019081337,"(24.0, 37.5]",Q2
36093,2020-03-15,155350,27,2,4,42,136,0.5714285714285714,0.3678330038162674,"(24.0, 37.5]",Q2
36093,2020-03-16,155350,27,1,5,27,163,0.7142857142857143,0.4597912547703343,"(24.0, 37.5]",Q2
36093,2020-03-17,155350,27,9,14,98,261,2.0,1.2874155133569358,"(24.0, 37.5]",Q2
36093,2020-03-18,155350,27,4,18,131,392,2.5714285714285716,1.6552485171732034,"(24.0, 37.5]",Q2
36093,2020-03-19,155350,27,3,21,115,507,3.0,1.931123270035404,"(24.0, 37.5]",Q2
36093,2020-03-20,155350,27,11,32,157,664,4.428571428571429,2.8507057795760726,"(24.0, 37.5]",Q2
36093,2020-03-21,155350,27,7,39,123,787,5.285714285714286,3.4024552853004733,"(24.0, 37.5]",Q2
36093,2020-03-22,155350,27,5,44,62,849,5.714285714285714,3.6783300381626742,"(24.0, 37.5]",Q2
36093,2020-03-23,155350,27,2,46,50,899,5.857142857142857,3.7702882891167406,"(24.0, 37.5]",Q2
36093,2020-03-24,155350,27,9,55,53,952,5.857142857142857,3.7702882891167406,"(24.0, 37.5]",Q2
36093,2020-03-25,155350,27,7,62,32,984,6.285714285714286,4.046163041978941,"(24.0, 37.5]",Q2
36093,2020-03-26,155350,27,4,66,41,1025,6.428571428571429,4.1381212929330085,"(24.0, 37.5]",Q2
36093,2020-03-27,155350,27,6,72,43,1068,5.714285714285714,3.6783300381626742,"(24.0, 37.5]",Q2
36093,2020-03-28,155350,27,4,76,28,1096,5.285714285714286,3.4024552853004733,"(24.0, 37.5]",Q2
36093,2020-03-29,155350,27,4,80,12,1108,5.142857142857143,3.310497034346407,"(24.0, 37.5]",Q2
36093,2020-03-30,155350,27,5,85,33,1141,5.571428571428571,3.5863717872086074,"(24.0, 37.5]",Q2
36093,2020-03-31,155350,27,8,93,22,1163,5.428571428571429,3.494413536254541,"(24.0, 37.5]",Q2
36093,2020-04-01,155350,27,8,101,31,1194,5.571428571428571,3.5863717872086074,"(24.0, 37.5]",Q2
36093,2020-04-02,155350,27,9,110,42,1236,6.285714285714286,4.046163041978941,"(24.0, 37.5]",Q2
36093,2020-04-03,155350,27,7,117,38,1274,6.428571428571429,4.1381212929330085,"(24.0, 37.5]",Q2
36093,2020-04-04,155350,27,11,128,64,1338,7.428571428571429,4.781829049611477,"(24.0, 37.5]",Q2
36093,2020-04-05,155350,27,10,138,64,1402,8.285714285714286,5.333578555335878,"(24.0, 37.5]",Q2
36093,2020-04-06,155350,27,7,145,35,1437,8.571428571428571,5.517495057244011,"(24.0, 37.5]",Q2
36093,2020-04-07,155350,27,4,149,23,1460,8.0,5.149662053427743,"(24.0, 37.5]",Q2
36093,2020-04-08,155350,27,18,167,104,1564,9.428571428571429,6.069244562968412,"(24.0, 37.5]",Q2
36093,2020-04-09,155350,27,24,191,183,1747,11.571428571428571,7.448618327279415,"(24.0, 37.5]",Q2
36093,2020-04-10,155350,27,3,194,24,1771,11.0,7.080785323463148,"(24.0, 37.5]",Q2
36093,2020-04-11,155350,27,5,199,27,1798,10.142857142857142,6.529035817738747,"(24.0, 37.5]",Q2
36093,2020-04-12,155350,27,5,204,27,1825,9.428571428571429,6.069244562968412,"(24.0, 37.5]",Q2
36093,2020-04-13,155350,27,31,235,232,2057,12.857142857142858,8.276242585866017,"(24.0, 37.5]",Q2
36093,2020-04-14,155350,27,2,237,18,2075,12.571428571428571,8.092326083957882,"(24.0, 37.5]",Q2
36093,2020-04-15,155350,27,8,245,45,2120,11.142857142857142,7.172743574417215,"(24.0, 37.5]",Q2
36093,2020-04-16,155350,27,5,250,35,2155,8.428571428571429,5.425536806289945,"(24.0, 37.5]",Q2
36093,2020-04-17,155350,27,9,259,38,2193,9.285714285714286,5.977286312014346,"(24.0, 37.5]",Q2
36093,2020-04-18,155350,27,9,268,36,2229,9.857142857142858,6.345119315830614,"(24.0, 37.5]",Q2
36093,2020-04-19,155350,27,1,269,23,2252,9.285714285714286,5.977286312014346,"(24.0, 37.5]",Q2
36093,2020-04-20,155350,27,4,273,23,2275,5.428571428571429,3.494413536254541,"(24.0, 37.5]",Q2
36093,2020-04-21,155350,27,7,280,24,2299,6.142857142857143,3.9542047910248748,"(24.0, 37.5]",Q2
36093,2020-04-22,155350,27,8,288,47,2346,6.142857142857143,3.9542047910248748,"(24.0, 37.5]",Q2
36093,2020-04-23,155350,27,9,297,33,2379,6.714285714285714,4.322037794841142,"(24.0, 37.5]",Q2
36093,2020-04-24,155350,27,134,431,964,3343,24.571428571428573,15.816819164099499,"(24.0, 37.5]",Q2
36093,2020-04-25,155350,27,18,449,186,3529,25.857142857142858,16.644443422686102,"(24.0, 37.5]",Q2
36093,2020-04-26,155350,27,8,457,96,3625,26.857142857142858,17.28815117936457,"(24.0, 37.5]",Q2
36093,2020-04-27,155350,27,12,469,119,3744,28.0,18.023817186997103,"(24.0, 37.5]",Q2
36093,2020-04-28,155350,27,10,479,184,3928,28.428571428571427,18.299691939859304,"(24.0, 37.5]",Q2
36093,2020-04-29,155350,27,22,501,246,4174,30.428571428571427,19.58710745321624,"(24.0, 37.5]",Q2
36093,2020-04-30,155350,27,13,514,195,4369,31.0,19.954940457032507,"(24.0, 37.5]",Q2
36093,2020-05-01,155350,27,7,521,194,4563,12.857142857142858,8.276242585866017,"(24.0, 37.5]",Q2
36093,2020-05-02,155350,27,6,527,146,4709,11.142857142857142,7.172743574417215,"(24.0, 37.5]",Q2
36093,2020-05-03,155350,27,8,535,126,4835,11.142857142857142,7.172743574417215,"(24.0, 37.5]",Q2
36093,2020-05-04,155350,27,2,537,98,4933,9.714285714285714,6.253161064876545,"(24.0, 37.5]",Q2
36093,2020-05-05,155350,27,14,551,178,5111,10.285714285714286,6.620994068692814,"(24.0, 37.5]",Q2
36093,2020-05-06,155350,27,0,551,194,5305,7.142857142857143,4.597912547703343,"(24.0, 37.5]",Q2
36093,2020-05-07,155350,27,7,558,144,5449,6.285714285714286,4.046163041978941,"(24.0, 37.5]",Q2
36093,2020-05-08,155350,27,13,571,204,5653,7.142857142857143,4.597912547703343,"(24.0, 37.5]",Q2
36093,2020-05-09,155350,27,0,571,199,5852,6.285714285714286,4.046163041978941,"(24.0, 37.5]",Q2
36093,2020-05-10,155350,27,4,575,113,5965,5.714285714285714,3.6783300381626742,"(24.0, 37.5]",Q2
36093,2020-05-11,155350,27,6,581,102,6067,6.285714285714286,4.046163041978941,"(24.0, 37.5]",Q2
36093,2020-05-12,155350,27,6,587,164,6231,5.142857142857143,3.310497034346407,"(24.0, 37.5]",Q2
36093,2020-05-13,155350,27,10,597,276,6507,6.571428571428571,4.230079543887075,"(24.0, 37.5]",Q2
36093,2020-05-14,155350,27,6,603,170,6677,6.428571428571429,4.1381212929330085,"(24.0, 37.5]",Q2
36093,2020-05-15,155350,27,10,613,272,6949,6.0,3.862246540070808,"(24.0, 37.5]",Q2
36093,2020-05-16,155350,27,7,620,175,7124,7.0,4.505954296749276,"(24.0, 37.5]",Q2
36093,2020-05-17,155350,27,9,629,233,7357,7.714285714285714,4.9657455515196105,"(24.0, 37.5]",Q2
36093,2020-05-18,155350,27,2,631,83,7440,7.142857142857143,4.597912547703343,"(24.0, 37.5]",Q2
36093,2020-05-19,155350,27,2,633,392,7832,6.571428571428571,4.230079543887075,"(24.0, 37.5]",Q2
36093,2020-05-20,155350,27,5,638,378,8210,5.857142857142857,3.7702882891167406,"(24.0, 37.5]",Q2
36093,2020-05-21,155350,27,7,645,667,8877,6.0,3.862246540070808,"(24.0, 37.5]",Q2
36093,2020-05-22,155350,27,3,648,248,9125,5.0,3.21853878339234,"(24.0, 37.5]",Q2
36093,2020-05-23,155350,27,10,658,641,9766,5.428571428571429,3.494413536254541,"(24.0, 37.5]",Q2
36093,2020-05-24,155350,27,6,664,340,10106,5.0,3.21853878339234,"(24.0, 37.5]",Q2
36093,2020-05-25,155350,27,4,668,143,10249,5.285714285714286,3.4024552853004733,"(24.0, 37.5]",Q2
36093,2020-05-26,155350,27,5,673,243,10492,5.714285714285714,3.6783300381626742,"(24.0, 37.5]",Q2
36093,2020-05-27,155350,27,3,676,485,10977,5.428571428571429,3.494413536254541,"(24.0, 37.5]",Q2
36093,2020-05-28,155350,27,4,680,792,11769,5.0,3.21853878339234,"(24.0, 37.5]",Q2
36093,2020-05-29,155350,27,6,686,477,12246,5.428571428571429,3.494413536254541,"(24.0, 37.5]",Q2
36093,2020-05-30,155350,27,3,689,324,12570,4.428571428571429,2.8507057795760726,"(24.0, 37.5]",Q2
36093,2020-05-31,155350,27,4,693,482,13052,4.142857142857143,2.666789277667939,"(24.0, 37.5]",Q2
36093,2020-06-01,155350,27,3,696,481,13533,4.0,2.5748310267138717,"(24.0, 37.5]",Q2
36093,2020-06-02,155350,27,5,701,406,13939,4.0,2.5748310267138717,"(24.0, 37.5]",Q2
36093,2020-06-03,155350,27,0,701,565,14504,3.5714285714285716,2.2989562738516716,"(24.0, 37.5]",Q2
36093,2020-06-04,155350,27,5,706,802,15306,3.7142857142857144,2.3909145248057384,"(24.0, 37.5]",Q2
36093,2020-06-05,155350,27,4,710,497,15803,3.4285714285714284,2.2069980228976043,"(24.0, 37.5]",Q2
36093,2020-06-06,155350,27,1,711,579,16382,3.142857142857143,2.0230815209894706,"(24.0, 37.5]",Q2
36093,2020-06-07,155350,27,1,712,533,16915,2.7142857142857144,1.7472067681272705,"(24.0, 37.5]",Q2
36095,2020-03-02,31097,26,0,0,0,0,0.0,0.0,"(24.0, 37.5]",Q2
36095,2020-03-03,31097,26,0,0,0,0,0.0,0.0,"(24.0, 37.5]",Q2
36095,2020-03-04,31097,26,0,0,0,0,0.0,0.0,"(24.0, 37.5]",Q2
36095,2020-03-05,31097,26,0,0,0,0,0.0,0.0,"(24.0, 37.5]",Q2
36095,2020-03-06,31097,26,0,0,0,0,0.0,0.0,"(24.0, 37.5]",Q2
36095,2020-03-07,31097,26,0,0,0,0,0.0,0.0,"(24.0, 37.5]",Q2
36095,2020-03-08,31097,26,0,0,0,0,0.0,0.0,"(24.0, 37.5]",Q2
36095,2020-03-09,31097,26,0,0,0,0,0.0,0.0,"(24.0, 37.5]",Q2
36095,2020-03-10,31097,26,0,0,0,0,0.0,0.0,"(24.0, 37.5]",Q2
36095,2020-03-11,31097,26,0,0,2,2,0.0,0.0,"(24.0, 37.5]",Q2
36095,2020-03-12,31097,26,0,0,1,3,0.0,0.0,"(24.0, 37.5]",Q2
36095,2020-03-13,31097,26,0,0,0,3,0.0,0.0,"(24.0, 37.5]",Q2
36095,2020-03-14,31097,26,0,0,0,3,0.0,0.0,"(24.0, 37.5]",Q2
36095,2020-03-15,31097,26,0,0,0,3,0.0,0.0,"(24.0, 37.5]",Q2
36095,2020-03-16,31097,26,0,0,0,3,0.0,0.0,"(24.0, 37.5]",Q2
36095,2020-03-17,31097,26,0,0,8,11,0.0,0.0,"(24.0, 37.5]",Q2
36095,2020-03-18,31097,26,1,1,8,19,0.14285714285714285,0.45939204057350497,"(24.0, 37.5]",Q2
36095,2020-03-19,31097,26,0,1,10,29,0.14285714285714285,0.45939204057350497,"(24.0, 37.5]",Q2
36095,2020-03-20,31097,26,0,1,16,45,0.14285714285714285,0.45939204057350497,"(24.0, 37.5]",Q2
36095,2020-03-21,31097,26,0,1,6,51,0.14285714285714285,0.45939204057350497,"(24.0, 37.5]",Q2
36095,2020-03-22,31097,26,0,1,3,54,0.14285714285714285,0.45939204057350497,"(24.0, 37.5]",Q2
36095,2020-03-23,31097,26,0,1,1,55,0.14285714285714285,0.45939204057350497,"(24.0, 37.5]",Q2
36095,2020-03-24,31097,26,1,2,3,58,0.2857142857142857,0.9187840811470099,"(24.0, 37.5]",Q2
36095,2020-03-25,31097,26,0,2,2,60,0.14285714285714285,0.45939204057350497,"(24.0, 37.5]",Q2
36095,2020-03-26,31097,26,1,3,3,63,0.2857142857142857,0.9187840811470099,"(24.0, 37.5]",Q2
36095,2020-03-27,31097,26,2,5,9,72,0.5714285714285714,1.8375681622940199,"(24.0, 37.5]",Q2
36095,2020-03-28,31097,26,0,5,5,77,0.5714285714285714,1.8375681622940199,"(24.0, 37.5]",Q2
36095,2020-03-29,31097,26,1,6,3,80,0.7142857142857143,2.296960202867525,"(24.0, 37.5]",Q2
36095,2020-03-30,31097,26,0,6,4,84,0.7142857142857143,2.296960202867525,"(24.0, 37.5]",Q2
36095,2020-03-31,31097,26,2,8,7,91,0.8571428571428571,2.75635224344103,"(24.0, 37.5]",Q2
36095,2020-04-01,31097,26,0,8,10,101,0.8571428571428571,2.75635224344103,"(24.0, 37.5]",Q2
36095,2020-04-02,31097,26,1,9,5,106,0.8571428571428571,2.75635224344103,"(24.0, 37.5]",Q2
36095,2020-04-03,31097,26,1,10,21,127,0.7142857142857143,2.296960202867525,"(24.0, 37.5]",Q2
36095,2020-04-04,31097,26,1,11,16,143,0.8571428571428571,2.75635224344103,"(24.0, 37.5]",Q2
36095,2020-04-05,31097,26,0,11,17,160,0.7142857142857143,2.296960202867525,"(24.0, 37.5]",Q2
36095,2020-04-06,31097,26,1,12,19,179,0.8571428571428571,2.75635224344103,"(24.0, 37.5]",Q2
36095,2020-04-07,31097,26,0,12,20,199,0.5714285714285714,1.8375681622940199,"(24.0, 37.5]",Q2
36095,2020-04-08,31097,26,0,12,8,207,0.5714285714285714,1.8375681622940199,"(24.0, 37.5]",Q2
36095,2020-04-09,31097,26,0,12,16,223,0.42857142857142855,1.378176121720515,"(24.0, 37.5]",Q2
36095,2020-04-10,31097,26,0,12,5,228,0.2857142857142857,0.9187840811470099,"(24.0, 37.5]",Q2
36095,2020-04-11,31097,26,0,12,2,230,0.14285714285714285,0.45939204057350497,"(24.0, 37.5]",Q2
36095,2020-04-12,31097,26,0,12,4,234,0.14285714285714285,0.45939204057350497,"(24.0, 37.5]",Q2
36095,2020-04-13,31097,26,8,20,59,293,1.1428571428571428,3.6751363245880397,"(24.0, 37.5]",Q2
36095,2020-04-14,31097,26,0,20,1,294,1.1428571428571428,3.6751363245880397,"(24.0, 37.5]",Q2
36095,2020-04-15,31097,26,0,20,5,299,1.1428571428571428,3.6751363245880397,"(24.0, 37.5]",Q2
36095,2020-04-16,31097,26,0,20,0,299,1.1428571428571428,3.6751363245880397,"(24.0, 37.5]",Q2
36095,2020-04-17,31097,26,0,20,1,300,1.1428571428571428,3.6751363245880397,"(24.0, 37.5]",Q2
36095,2020-04-18,31097,26,0,20,2,302,1.1428571428571428,3.6751363245880397,"(24.0, 37.5]",Q2
36095,2020-04-19,31097,26,0,20,4,306,1.1428571428571428,3.6751363245880397,"(24.0, 37.5]",Q2
36095,2020-04-20,31097,26,0,20,4,310,0.0,0.0,"(24.0, 37.5]",Q2
36095,2020-04-21,31097,26,0,20,0,310,0.0,0.0,"(24.0, 37.5]",Q2
36095,2020-04-22,31097,26,1,21,8,318,0.14285714285714285,0.45939204057350497,"(24.0, 37.5]",Q2
36095,2020-04-23,31097,26,0,21,13,331,0.14285714285714285,0.45939204057350497,"(24.0, 37.5]",Q2
36095,2020-04-24,31097,26,12,33,177,508,1.8571428571428572,5.972096527455566,"(24.0, 37.5]",Q2
36095,2020-04-25,31097,26,2,35,29,537,2.142857142857143,6.890880608602576,"(24.0, 37.5]",Q2
36095,2020-04-26,31097,26,0,35,15,552,2.142857142857143,6.890880608602576,"(24.0, 37.5]",Q2
36095,2020-04-27,31097,26,3,38,19,571,2.5714285714285716,8.26905673032309,"(24.0, 37.5]",Q2
36095,2020-04-28,31097,26,1,39,21,592,2.7142857142857144,8.728448770896597,"(24.0, 37.5]",Q2
36095,2020-04-29,31097,26,3,42,17,609,3.0,9.647232852043606,"(24.0, 37.5]",Q2
36095,2020-04-30,31097,26,1,43,24,633,3.142857142857143,10.106624892617111,"(24.0, 37.5]",Q2
36095,2020-05-01,31097,26,0,43,16,649,1.4285714285714286,4.59392040573505,"(24.0, 37.5]",Q2
36095,2020-05-02,31097,26,2,45,20,669,1.4285714285714286,4.59392040573505,"(24.0, 37.5]",Q2
36095,2020-05-03,31097,26,0,45,21,690,1.4285714285714286,4.59392040573505,"(24.0, 37.5]",Q2
36095,2020-05-04,31097,26,0,45,29,719,1.0,3.215744284014535,"(24.0, 37.5]",Q2
36095,2020-05-05,31097,26,0,45,29,748,0.8571428571428571,2.75635224344103,"(24.0, 37.5]",Q2
36095,2020-05-06,31097,26,0,45,20,768,0.42857142857142855,1.378176121720515,"(24.0, 37.5]",Q2
36095,2020-05-07,31097,26,0,45,15,783,0.2857142857142857,0.9187840811470099,"(24.0, 37.5]",Q2
36095,2020-05-08,31097,26,1,46,32,815,0.42857142857142855,1.378176121720515,"(24.0, 37.5]",Q2
36095,2020-05-09,31097,26,0,46,23,838,0.14285714285714285,0.45939204057350497,"(24.0, 37.5]",Q2
36095,2020-05-10,31097,26,0,46,19,857,0.14285714285714285,0.45939204057350497,"(24.0, 37.5]",Q2
36095,2020-05-11,31097,26,0,46,32,889,0.14285714285714285,0.45939204057350497,"(24.0, 37.5]",Q2
36095,2020-05-12,31097,26,1,47,27,916,0.2857142857142857,0.9187840811470099,"(24.0, 37.5]",Q2
36095,2020-05-13,31097,26,0,47,32,948,0.2857142857142857,0.9187840811470099,"(24.0, 37.5]",Q2
36095,2020-05-14,31097,26,0,47,8,956,0.2857142857142857,0.9187840811470099,"(24.0, 37.5]",Q2
36095,2020-05-15,31097,26,0,47,22,978,0.14285714285714285,0.45939204057350497,"(24.0, 37.5]",Q2
36095,2020-05-16,31097,26,0,47,39,1017,0.14285714285714285,0.45939204057350497,"(24.0, 37.5]",Q2
36095,2020-05-17,31097,26,1,48,36,1053,0.2857142857142857,0.9187840811470099,"(24.0, 37.5]",Q2
36095,2020-05-18,31097,26,0,48,21,1074,0.2857142857142857,0.9187840811470099,"(24.0, 37.5]",Q2
36095,2020-05-19,31097,26,0,48,34,1108,0.14285714285714285,0.45939204057350497,"(24.0, 37.5]",Q2
36095,2020-05-20,31097,26,1,49,33,1141,0.2857142857142857,0.9187840811470099,"(24.0, 37.5]",Q2
36095,2020-05-21,31097,26,0,49,27,1168,0.2857142857142857,0.9187840811470099,"(24.0, 37.5]",Q2
36095,2020-05-22,31097,26,0,49,23,1191,0.2857142857142857,0.9187840811470099,"(24.0, 37.5]",Q2
36095,2020-05-23,31097,26,0,49,29,1220,0.2857142857142857,0.9187840811470099,"(24.0, 37.5]",Q2
36095,2020-05-24,31097,26,0,49,21,1241,0.14285714285714285,0.45939204057350497,"(24.0, 37.5]",Q2
36095,2020-05-25,31097,26,0,49,12,1253,0.14285714285714285,0.45939204057350497,"(24.0, 37.5]",Q2
36095,2020-05-26,31097,26,0,49,46,1299,0.14285714285714285,0.45939204057350497,"(24.0, 37.5]",Q2
36095,2020-05-27,31097,26,0,49,74,1373,0.0,0.0,"(24.0, 37.5]",Q2
36095,2020-05-28,31097,26,0,49,32,1405,0.0,0.0,"(24.0, 37.5]",Q2
36095,2020-05-29,31097,26,1,50,32,1437,0.14285714285714285,0.45939204057350497,"(24.0, 37.5]",Q2
36095,2020-05-30,31097,26,0,50,41,1478,0.14285714285714285,0.45939204057350497,"(24.0, 37.5]",Q2
36095,2020-05-31,31097,26,0,50,47,1525,0.14285714285714285,0.45939204057350497,"(24.0, 37.5]",Q2
36095,2020-06-01,31097,26,1,51,39,1564,0.2857142857142857,0.9187840811470099,"(24.0, 37.5]",Q2
36095,2020-06-02,31097,26,0,51,46,1610,0.2857142857142857,0.9187840811470099,"(24.0, 37.5]",Q2
36095,2020-06-03,31097,26,0,51,63,1673,0.2857142857142857,0.9187840811470099,"(24.0, 37.5]",Q2
36095,2020-06-04,31097,26,0,51,60,1733,0.2857142857142857,0.9187840811470099,"(24.0, 37.5]",Q2
36095,2020-06-05,31097,26,3,54,85,1818,0.5714285714285714,1.8375681622940199,"(24.0, 37.5]",Q2
36095,2020-06-06,31097,26,0,54,59,1877,0.5714285714285714,1.8375681622940199,"(24.0, 37.5]",Q2
36095,2020-06-07,31097,26,0,54,65,1942,0.5714285714285714,1.8375681622940199,"(24.0, 37.5]",Q2
36097,2020-03-02,17912,22,0,0,0,0,0.0,0.0,"(3.999, 24.0]",Q1
36097,2020-03-03,17912,22,0,0,0,0,0.0,0.0,"(3.999, 24.0]",Q1
36097,2020-03-04,17912,22,0,0,0,0,0.0,0.0,"(3.999, 24.0]",Q1
36097,2020-03-05,17912,22,0,0,0,0,0.0,0.0,"(3.999, 24.0]",Q1
36097,2020-03-06,17912,22,0,0,0,0,0.0,0.0,"(3.999, 24.0]",Q1
36097,2020-03-07,17912,22,0,0,0,0,0.0,0.0,"(3.999, 24.0]",Q1
36097,2020-03-08,17912,22,0,0,0,0,0.0,0.0,"(3.999, 24.0]",Q1
36097,2020-03-09,17912,22,0,0,0,0,0.0,0.0,"(3.999, 24.0]",Q1
36097,2020-03-10,17912,22,0,0,0,0,0.0,0.0,"(3.999, 24.0]",Q1
36097,2020-03-11,17912,22,0,0,0,0,0.0,0.0,"(3.999, 24.0]",Q1
36097,2020-03-12,17912,22,0,0,0,0,0.0,0.0,"(3.999, 24.0]",Q1
36097,2020-03-13,17912,22,0,0,0,0,0.0,0.0,"(3.999, 24.0]",Q1
36097,2020-03-14,17912,22,0,0,1,1,0.0,0.0,"(3.999, 24.0]",Q1
36097,2020-03-15,17912,22,0,0,1,2,0.0,0.0,"(3.999, 24.0]",Q1
36097,2020-03-16,17912,22,0,0,2,4,0.0,0.0,"(3.999, 24.0]",Q1
36097,2020-03-17,17912,22,0,0,0,4,0.0,0.0,"(3.999, 24.0]",Q1
36097,2020-03-18,17912,22,0,0,1,5,0.0,0.0,"(3.999, 24.0]",Q1
36097,2020-03-19,17912,22,0,0,0,5,0.0,0.0,"(3.999, 24.0]",Q1
36097,2020-03-20,17912,22,0,0,9,14,0.0,0.0,"(3.999, 24.0]",Q1
36097,2020-03-21,17912,22,0,0,3,17,0.0,0.0,"(3.999, 24.0]",Q1
36097,2020-03-22,17912,22,0,0,7,24,0.0,0.0,"(3.999, 24.0]",Q1
36097,2020-03-23,17912,22,0,0,8,32,0.0,0.0,"(3.999, 24.0]",Q1
36097,2020-03-24,17912,22,0,0,0,32,0.0,0.0,"(3.999, 24.0]",Q1
36097,2020-03-25,17912,22,0,0,1,33,0.0,0.0,"(3.999, 24.0]",Q1
36097,2020-03-26,17912,22,0,0,8,41,0.0,0.0,"(3.999, 24.0]",Q1
36097,2020-03-27,17912,22,1,1,6,47,0.14285714285714285,0.7975499266254067,"(3.999, 24.0]",Q1
36097,2020-03-28,17912,22,0,1,7,54,0.14285714285714285,0.7975499266254067,"(3.999, 24.0]",Q1
36097,2020-03-29,17912,22,1,2,6,60,0.2857142857142857,1.5950998532508134,"(3.999, 24.0]",Q1
36097,2020-03-30,17912,22,0,2,6,66,0.2857142857142857,1.5950998532508134,"(3.999, 24.0]",Q1
36097,2020-03-31,17912,22,0,2,1,67,0.2857142857142857,1.5950998532508134,"(3.999, 24.0]",Q1
36097,2020-04-01,17912,22,1,3,8,75,0.42857142857142855,2.39264977987622,"(3.999, 24.0]",Q1
36097,2020-04-02,17912,22,0,3,13,88,0.42857142857142855,2.39264977987622,"(3.999, 24.0]",Q1
36097,2020-04-03,17912,22,1,4,5,93,0.42857142857142855,2.39264977987622,"(3.999, 24.0]",Q1
36097,2020-04-04,17912,22,0,4,2,95,0.42857142857142855,2.39264977987622,"(3.999, 24.0]",Q1
36097,2020-04-05,17912,22,0,4,9,104,0.2857142857142857,1.5950998532508134,"(3.999, 24.0]",Q1
36097,2020-04-06,17912,22,0,4,4,108,0.2857142857142857,1.5950998532508134,"(3.999, 24.0]",Q1
36097,2020-04-07,17912,22,0,4,12,120,0.2857142857142857,1.5950998532508134,"(3.999, 24.0]",Q1
36097,2020-04-08,17912,22,0,4,20,140,0.14285714285714285,0.7975499266254067,"(3.999, 24.0]",Q1
36097,2020-04-09,17912,22,1,5,4,144,0.2857142857142857,1.5950998532508134,"(3.999, 24.0]",Q1
36097,2020-04-10,17912,22,0,5,7,151,0.14285714285714285,0.7975499266254067,"(3.999, 24.0]",Q1
36097,2020-04-11,17912,22,0,5,1,152,0.14285714285714285,0.7975499266254067,"(3.999, 24.0]",Q1
36097,2020-04-12,17912,22,0,5,1,153,0.14285714285714285,0.7975499266254067,"(3.999, 24.0]",Q1
36097,2020-04-13,17912,22,1,6,11,164,0.2857142857142857,1.5950998532508134,"(3.999, 24.0]",Q1
36097,2020-04-14,17912,22,0,6,0,164,0.2857142857142857,1.5950998532508134,"(3.999, 24.0]",Q1
36097,2020-04-15,17912,22,0,6,5,169,0.2857142857142857,1.5950998532508134,"(3.999, 24.0]",Q1
36097,2020-04-16,17912,22,0,6,8,177,0.14285714285714285,0.7975499266254067,"(3.999, 24.0]",Q1
36097,2020-04-17,17912,22,0,6,4,181,0.14285714285714285,0.7975499266254067,"(3.999, 24.0]",Q1
36097,2020-04-18,17912,22,0,6,0,181,0.14285714285714285,0.7975499266254067,"(3.999, 24.0]",Q1
36097,2020-04-19,17912,22,1,7,4,185,0.2857142857142857,1.5950998532508134,"(3.999, 24.0]",Q1
36097,2020-04-20,17912,22,0,7,4,189,0.14285714285714285,0.7975499266254067,"(3.999, 24.0]",Q1
36097,2020-04-21,17912,22,0,7,10,199,0.14285714285714285,0.7975499266254067,"(3.999, 24.0]",Q1
36097,2020-04-22,17912,22,0,7,108,307,0.14285714285714285,0.7975499266254067,"(3.999, 24.0]",Q1
36097,2020-04-23,17912,22,0,7,18,325,0.14285714285714285,0.7975499266254067,"(3.999, 24.0]",Q1
36097,2020-04-24,17912,22,0,7,38,363,0.14285714285714285,0.7975499266254067,"(3.999, 24.0]",Q1
36097,2020-04-25,17912,22,0,7,10,373,0.14285714285714285,0.7975499266254067,"(3.999, 24.0]",Q1
36097,2020-04-26,17912,22,0,7,9,382,0.0,0.0,"(3.999, 24.0]",Q1
36097,2020-04-27,17912,22,0,7,8,390,0.0,0.0,"(3.999, 24.0]",Q1
36097,2020-04-28,17912,22,0,7,15,405,0.0,0.0,"(3.999, 24.0]",Q1
36097,2020-04-29,17912,22,0,7,7,412,0.0,0.0,"(3.999, 24.0]",Q1
36097,2020-04-30,17912,22,0,7,6,418,0.0,0.0,"(3.999, 24.0]",Q1
36097,2020-05-01,17912,22,0,7,7,425,0.0,0.0,"(3.999, 24.0]",Q1
36097,2020-05-02,17912,22,0,7,2,427,0.0,0.0,"(3.999, 24.0]",Q1
36097,2020-05-03,17912,22,0,7,12,439,0.0,0.0,"(3.999, 24.0]",Q1
36097,2020-05-04,17912,22,0,7,5,444,0.0,0.0,"(3.999, 24.0]",Q1
36097,2020-05-05,17912,22,0,7,31,475,0.0,0.0,"(3.999, 24.0]",Q1
36097,2020-05-06,17912,22,0,7,12,487,0.0,0.0,"(3.999, 24.0]",Q1
36097,2020-05-07,17912,22,0,7,9,496,0.0,0.0,"(3.999, 24.0]",Q1
36097,2020-05-08,17912,22,0,7,38,534,0.0,0.0,"(3.999, 24.0]",Q1
36097,2020-05-09,17912,22,0,7,31,565,0.0,0.0,"(3.999, 24.0]",Q1
36097,2020-05-10,17912,22,0,7,14,579,0.0,0.0,"(3.999, 24.0]",Q1
36097,2020-05-11,17912,22,1,8,17,596,0.14285714285714285,0.7975499266254067,"(3.999, 24.0]",Q1
36097,2020-05-12,17912,22,0,8,32,628,0.14285714285714285,0.7975499266254067,"(3.999, 24.0]",Q1
36097,2020-05-13,17912,22,0,8,46,674,0.14285714285714285,0.7975499266254067,"(3.999, 24.0]",Q1
36097,2020-05-14,17912,22,0,8,18,692,0.14285714285714285,0.7975499266254067,"(3.999, 24.0]",Q1
36097,2020-05-15,17912,22,0,8,52,744,0.14285714285714285,0.7975499266254067,"(3.999, 24.0]",Q1
36097,2020-05-16,17912,22,1,9,32,776,0.2857142857142857,1.5950998532508134,"(3.999, 24.0]",Q1
36097,2020-05-17,17912,22,1,10,55,831,0.42857142857142855,2.39264977987622,"(3.999, 24.0]",Q1
36097,2020-05-18,17912,22,0,10,57,888,0.2857142857142857,1.5950998532508134,"(3.999, 24.0]",Q1
36097,2020-05-19,17912,22,0,10,44,932,0.2857142857142857,1.5950998532508134,"(3.999, 24.0]",Q1
36097,2020-05-20,17912,22,0,10,42,974,0.2857142857142857,1.5950998532508134,"(3.999, 24.0]",Q1
36097,2020-05-21,17912,22,1,11,49,1023,0.42857142857142855,2.39264977987622,"(3.999, 24.0]",Q1
36097,2020-05-22,17912,22,0,11,78,1101,0.42857142857142855,2.39264977987622,"(3.999, 24.0]",Q1
36097,2020-05-23,17912,22,0,11,45,1146,0.2857142857142857,1.5950998532508134,"(3.999, 24.0]",Q1
36097,2020-05-24,17912,22,0,11,52,1198,0.14285714285714285,0.7975499266254067,"(3.999, 24.0]",Q1
36097,2020-05-25,17912,22,0,11,14,1212,0.14285714285714285,0.7975499266254067,"(3.999, 24.0]",Q1
36097,2020-05-26,17912,22,0,11,68,1280,0.14285714285714285,0.7975499266254067,"(3.999, 24.0]",Q1
36097,2020-05-27,17912,22,0,11,41,1321,0.14285714285714285,0.7975499266254067,"(3.999, 24.0]",Q1
36097,2020-05-28,17912,22,0,11,52,1373,0.0,0.0,"(3.999, 24.0]",Q1
36097,2020-05-29,17912,22,0,11,64,1437,0.0,0.0,"(3.999, 24.0]",Q1
36097,2020-05-30,17912,22,0,11,76,1513,0.0,0.0,"(3.999, 24.0]",Q1
36097,2020-05-31,17912,22,0,11,30,1543,0.0,0.0,"(3.999, 24.0]",Q1
36097,2020-06-01,17912,22,1,12,26,1569,0.14285714285714285,0.7975499266254067,"(3.999, 24.0]",Q1
36097,2020-06-02,17912,22,0,12,40,1609,0.14285714285714285,0.7975499266254067,"(3.999, 24.0]",Q1
36097,2020-06-03,17912,22,0,12,22,1631,0.14285714285714285,0.7975499266254067,"(3.999, 24.0]",Q1
36097,2020-06-04,17912,22,0,12,32,1663,0.14285714285714285,0.7975499266254067,"(3.999, 24.0]",Q1
36097,2020-06-05,17912,22,0,12,139,1802,0.14285714285714285,0.7975499266254067,"(3.999, 24.0]",Q1
36097,2020-06-06,17912,22,0,12,47,1849,0.14285714285714285,0.7975499266254067,"(3.999, 24.0]",Q1
36097,2020-06-07,17912,22,0,12,45,1894,0.14285714285714285,0.7975499266254067,"(3.999, 24.0]",Q1
36099,2020-03-02,34300,26,0,0,0,0,0.0,0.0,"(24.0, 37.5]",Q2
36099,2020-03-03,34300,26,0,0,0,0,0.0,0.0,"(24.0, 37.5]",Q2
36099,2020-03-04,34300,26,0,0,0,0,0.0,0.0,"(24.0, 37.5]",Q2
36099,2020-03-05,34300,26,0,0,0,0,0.0,0.0,"(24.0, 37.5]",Q2
36099,2020-03-06,34300,26,0,0,0,0,0.0,0.0,"(24.0, 37.5]",Q2
36099,2020-03-07,34300,26,0,0,0,0,0.0,0.0,"(24.0, 37.5]",Q2
36099,2020-03-08,34300,26,0,0,0,0,0.0,0.0,"(24.0, 37.5]",Q2
36099,2020-03-09,34300,26,0,0,0,0,0.0,0.0,"(24.0, 37.5]",Q2
36099,2020-03-10,34300,26,0,0,0,0,0.0,0.0,"(24.0, 37.5]",Q2
36099,2020-03-11,34300,26,0,0,0,0,0.0,0.0,"(24.0, 37.5]",Q2
36099,2020-03-12,34300,26,0,0,0,0,0.0,0.0,"(24.0, 37.5]",Q2
36099,2020-03-13,34300,26,0,0,0,0,0.0,0.0,"(24.0, 37.5]",Q2
36099,2020-03-14,34300,26,0,0,0,0,0.0,0.0,"(24.0, 37.5]",Q2
36099,2020-03-15,34300,26,0,0,1,1,0.0,0.0,"(24.0, 37.5]",Q2
36099,2020-03-16,34300,26,0,0,1,2,0.0,0.0,"(24.0, 37.5]",Q2
36099,2020-03-17,34300,26,0,0,1,3,0.0,0.0,"(24.0, 37.5]",Q2
36099,2020-03-18,34300,26,0,0,2,5,0.0,0.0,"(24.0, 37.5]",Q2
36099,2020-03-19,34300,26,0,0,2,7,0.0,0.0,"(24.0, 37.5]",Q2
36099,2020-03-20,34300,26,0,0,6,13,0.0,0.0,"(24.0, 37.5]",Q2
36099,2020-03-21,34300,26,0,0,3,16,0.0,0.0,"(24.0, 37.5]",Q2
36099,2020-03-22,34300,26,0,0,4,20,0.0,0.0,"(24.0, 37.5]",Q2
36099,2020-03-23,34300,26,0,0,11,31,0.0,0.0,"(24.0, 37.5]",Q2
36099,2020-03-24,34300,26,0,0,0,31,0.0,0.0,"(24.0, 37.5]",Q2
36099,2020-03-25,34300,26,0,0,6,37,0.0,0.0,"(24.0, 37.5]",Q2
36099,2020-03-26,34300,26,0,0,11,48,0.0,0.0,"(24.0, 37.5]",Q2
36099,2020-03-27,34300,26,0,0,16,64,0.0,0.0,"(24.0, 37.5]",Q2
36099,2020-03-28,34300,26,0,0,4,68,0.0,0.0,"(24.0, 37.5]",Q2
36099,2020-03-29,34300,26,0,0,5,73,0.0,0.0,"(24.0, 37.5]",Q2
36099,2020-03-30,34300,26,2,2,7,80,0.2857142857142857,0.8329862557267805,"(24.0, 37.5]",Q2
36099,2020-03-31,34300,26,0,2,1,81,0.2857142857142857,0.8329862557267805,"(24.0, 37.5]",Q2
36099,2020-04-01,34300,26,2,4,14,95,0.5714285714285714,1.665972511453561,"(24.0, 37.5]",Q2
36099,2020-04-02,34300,26,2,6,13,108,0.8571428571428571,2.4989587671803415,"(24.0, 37.5]",Q2
36099,2020-04-03,34300,26,0,6,7,115,0.8571428571428571,2.4989587671803415,"(24.0, 37.5]",Q2
36099,2020-04-04,34300,26,3,9,15,130,1.2857142857142858,3.7484381507705122,"(24.0, 37.5]",Q2
36099,2020-04-05,34300,26,0,9,11,141,1.2857142857142858,3.7484381507705122,"(24.0, 37.5]",Q2
36099,2020-04-06,34300,26,1,10,8,149,1.1428571428571428,3.331945022907122,"(24.0, 37.5]",Q2
36099,2020-04-07,34300,26,2,12,14,163,1.4285714285714286,4.164931278633903,"(24.0, 37.5]",Q2
36099,2020-04-08,34300,26,3,15,20,183,1.5714285714285714,4.581424406497293,"(24.0, 37.5]",Q2
36099,2020-04-09,34300,26,0,15,8,191,1.2857142857142858,3.7484381507705122,"(24.0, 37.5]",Q2
36099,2020-04-10,34300,26,1,16,5,196,1.4285714285714286,4.164931278633903,"(24.0, 37.5]",Q2
36099,2020-04-11,34300,26,0,16,3,199,1.0,2.915451895043732,"(24.0, 37.5]",Q2
36099,2020-04-12,34300,26,0,16,1,200,1.0,2.915451895043732,"(24.0, 37.5]",Q2
36099,2020-04-13,34300,26,2,18,33,233,1.1428571428571428,3.331945022907122,"(24.0, 37.5]",Q2
36099,2020-04-14,34300,26,0,18,1,234,0.8571428571428571,2.4989587671803415,"(24.0, 37.5]",Q2
36099,2020-04-15,34300,26,0,18,2,236,0.42857142857142855,1.2494793835901707,"(24.0, 37.5]",Q2
36099,2020-04-16,34300,26,0,18,3,239,0.42857142857142855,1.2494793835901707,"(24.0, 37.5]",Q2
36099,2020-04-17,34300,26,0,18,2,241,0.2857142857142857,0.8329862557267805,"(24.0, 37.5]",Q2
36099,2020-04-18,34300,26,0,18,5,246,0.2857142857142857,0.8329862557267805,"(24.0, 37.5]",Q2
36099,2020-04-19,34300,26,0,18,2,248,0.2857142857142857,0.8329862557267805,"(24.0, 37.5]",Q2
36099,2020-04-20,34300,26,0,18,0,248,0.0,0.0,"(24.0, 37.5]",Q2
36099,2020-04-21,34300,26,0,18,3,251,0.0,0.0,"(24.0, 37.5]",Q2
36099,2020-04-22,34300,26,0,18,15,266,0.0,0.0,"(24.0, 37.5]",Q2
36099,2020-04-23,34300,26,0,18,5,271,0.0,0.0,"(24.0, 37.5]",Q2
36099,2020-04-24,34300,26,18,36,135,406,2.5714285714285716,7.4968763015410245,"(24.0, 37.5]",Q2
36099,2020-04-25,34300,26,2,38,11,417,2.857142857142857,8.329862557267806,"(24.0, 37.5]",Q2
36099,2020-04-26,34300,26,0,38,12,429,2.857142857142857,8.329862557267806,"(24.0, 37.5]",Q2
36099,2020-04-27,34300,26,0,38,9,438,2.857142857142857,8.329862557267806,"(24.0, 37.5]",Q2
36099,2020-04-28,34300,26,0,38,13,451,2.857142857142857,8.329862557267806,"(24.0, 37.5]",Q2
36099,2020-04-29,34300,26,1,39,24,475,3.0,8.746355685131196,"(24.0, 37.5]",Q2
36099,2020-04-30,34300,26,2,41,22,497,3.2857142857142856,9.579341940857976,"(24.0, 37.5]",Q2
36099,2020-05-01,34300,26,1,42,26,523,0.8571428571428571,2.4989587671803415,"(24.0, 37.5]",Q2
36099,2020-05-02,34300,26,3,45,51,574,1.0,2.915451895043732,"(24.0, 37.5]",Q2
36099,2020-05-03,34300,26,0,45,19,593,1.0,2.915451895043732,"(24.0, 37.5]",Q2
36099,2020-05-04,34300,26,1,46,26,619,1.1428571428571428,3.331945022907122,"(24.0, 37.5]",Q2
36099,2020-05-05,34300,26,0,46,20,639,1.1428571428571428,3.331945022907122,"(24.0, 37.5]",Q2
36099,2020-05-06,34300,26,0,46,24,663,1.0,2.915451895043732,"(24.0, 37.5]",Q2
36099,2020-05-07,34300,26,0,46,19,682,0.7142857142857143,2.0824656393169514,"(24.0, 37.5]",Q2
36099,2020-05-08,34300,26,2,48,46,728,0.8571428571428571,2.4989587671803415,"(24.0, 37.5]",Q2
36099,2020-05-09,34300,26,1,49,42,770,0.5714285714285714,1.665972511453561,"(24.0, 37.5]",Q2
36099,2020-05-10,34300,26,0,49,41,811,0.5714285714285714,1.665972511453561,"(24.0, 37.5]",Q2
36099,2020-05-11,34300,26,0,49,25,836,0.42857142857142855,1.2494793835901707,"(24.0, 37.5]",Q2
36099,2020-05-12,34300,26,0,49,49,885,0.42857142857142855,1.2494793835901707,"(24.0, 37.5]",Q2
36099,2020-05-13,34300,26,0,49,40,925,0.42857142857142855,1.2494793835901707,"(24.0, 37.5]",Q2
36099,2020-05-14,34300,26,0,49,30,955,0.42857142857142855,1.2494793835901707,"(24.0, 37.5]",Q2
36099,2020-05-15,34300,26,1,50,29,984,0.2857142857142857,0.8329862557267805,"(24.0, 37.5]",Q2
36099,2020-05-16,34300,26,1,51,48,1032,0.2857142857142857,0.8329862557267805,"(24.0, 37.5]",Q2
36099,2020-05-17,34300,26,0,51,122,1154,0.2857142857142857,0.8329862557267805,"(24.0, 37.5]",Q2
36099,2020-05-18,34300,26,0,51,65,1219,0.2857142857142857,0.8329862557267805,"(24.0, 37.5]",Q2
36099,2020-05-19,34300,26,1,52,50,1269,0.42857142857142855,1.2494793835901707,"(24.0, 37.5]",Q2
36099,2020-05-20,34300,26,0,52,79,1348,0.42857142857142855,1.2494793835901707,"(24.0, 37.5]",Q2
36099,2020-05-21,34300,26,2,54,54,1402,0.7142857142857143,2.0824656393169514,"(24.0, 37.5]",Q2
36099,2020-05-22,34300,26,0,54,51,1453,0.5714285714285714,1.665972511453561,"(24.0, 37.5]",Q2
36099,2020-05-23,34300,26,1,55,103,1556,0.5714285714285714,1.665972511453561,"(24.0, 37.5]",Q2
36099,2020-05-24,34300,26,0,55,56,1612,0.5714285714285714,1.665972511453561,"(24.0, 37.5]",Q2
36099,2020-05-25,34300,26,0,55,86,1698,0.5714285714285714,1.665972511453561,"(24.0, 37.5]",Q2
36099,2020-05-26,34300,26,0,55,50,1748,0.42857142857142855,1.2494793835901707,"(24.0, 37.5]",Q2
36099,2020-05-27,34300,26,1,56,77,1825,0.5714285714285714,1.665972511453561,"(24.0, 37.5]",Q2
36099,2020-05-28,34300,26,1,57,140,1965,0.42857142857142855,1.2494793835901707,"(24.0, 37.5]",Q2
36099,2020-05-29,34300,26,1,58,68,2033,0.5714285714285714,1.665972511453561,"(24.0, 37.5]",Q2
36099,2020-05-30,34300,26,0,58,138,2171,0.42857142857142855,1.2494793835901707,"(24.0, 37.5]",Q2
36099,2020-05-31,34300,26,1,59,81,2252,0.5714285714285714,1.665972511453561,"(24.0, 37.5]",Q2
36099,2020-06-01,34300,26,0,59,60,2312,0.5714285714285714,1.665972511453561,"(24.0, 37.5]",Q2
36099,2020-06-02,34300,26,1,60,157,2469,0.7142857142857143,2.0824656393169514,"(24.0, 37.5]",Q2
36099,2020-06-03,34300,26,0,60,106,2575,0.5714285714285714,1.665972511453561,"(24.0, 37.5]",Q2
36099,2020-06-04,34300,26,1,61,141,2716,0.5714285714285714,1.665972511453561,"(24.0, 37.5]",Q2
36099,2020-06-05,34300,26,0,61,165,2881,0.42857142857142855,1.2494793835901707,"(24.0, 37.5]",Q2
36099,2020-06-06,34300,26,0,61,162,3043,0.42857142857142855,1.2494793835901707,"(24.0, 37.5]",Q2
36099,2020-06-07,34300,26,0,61,118,3161,0.2857142857142857,0.8329862557267805,"(24.0, 37.5]",Q2
36101,2020-03-02,95796,45,0,0,0,0,0.0,0.0,"(37.5, 52.0]",Q3
36101,2020-03-03,95796,45,0,0,0,0,0.0,0.0,"(37.5, 52.0]",Q3
36101,2020-03-04,95796,45,0,0,0,0,0.0,0.0,"(37.5, 52.0]",Q3
36101,2020-03-05,95796,45,0,0,0,0,0.0,0.0,"(37.5, 52.0]",Q3
36101,2020-03-06,95796,45,0,0,0,0,0.0,0.0,"(37.5, 52.0]",Q3
36101,2020-03-07,95796,45,0,0,0,0,0.0,0.0,"(37.5, 52.0]",Q3
36101,2020-03-08,95796,45,0,0,0,0,0.0,0.0,"(37.5, 52.0]",Q3
36101,2020-03-09,95796,45,0,0,0,0,0.0,0.0,"(37.5, 52.0]",Q3
36101,2020-03-10,95796,45,0,0,0,0,0.0,0.0,"(37.5, 52.0]",Q3
36101,2020-03-11,95796,45,0,0,0,0,0.0,0.0,"(37.5, 52.0]",Q3
36101,2020-03-12,95796,45,0,0,0,0,0.0,0.0,"(37.5, 52.0]",Q3
36101,2020-03-13,95796,45,0,0,1,1,0.0,0.0,"(37.5, 52.0]",Q3
36101,2020-03-14,95796,45,0,0,0,1,0.0,0.0,"(37.5, 52.0]",Q3
36101,2020-03-15,95796,45,0,0,0,1,0.0,0.0,"(37.5, 52.0]",Q3
36101,2020-03-16,95796,45,0,0,0,1,0.0,0.0,"(37.5, 52.0]",Q3
36101,2020-03-17,95796,45,0,0,0,1,0.0,0.0,"(37.5, 52.0]",Q3
36101,2020-03-18,95796,45,0,0,4,5,0.0,0.0,"(37.5, 52.0]",Q3
36101,2020-03-19,95796,45,0,0,3,8,0.0,0.0,"(37.5, 52.0]",Q3
36101,2020-03-20,95796,45,2,2,27,35,0.2857142857142857,0.29825283489319565,"(37.5, 52.0]",Q3
36101,2020-03-21,95796,45,1,3,17,52,0.42857142857142855,0.4473792523397935,"(37.5, 52.0]",Q3
36101,2020-03-22,95796,45,1,4,10,62,0.5714285714285714,0.5965056697863913,"(37.5, 52.0]",Q3
36101,2020-03-23,95796,45,1,5,2,64,0.7142857142857143,0.7456320872329891,"(37.5, 52.0]",Q3
36101,2020-03-24,95796,45,3,8,13,77,1.1428571428571428,1.1930113395727826,"(37.5, 52.0]",Q3
36101,2020-03-25,95796,45,3,11,30,107,1.5714285714285714,1.6403905919125763,"(37.5, 52.0]",Q3
36101,2020-03-26,95796,45,1,12,25,132,1.7142857142857142,1.789517009359174,"(37.5, 52.0]",Q3
36101,2020-03-27,95796,45,1,13,27,159,1.5714285714285714,1.6403905919125763,"(37.5, 52.0]",Q3
36101,2020-03-28,95796,45,4,17,22,181,2.0,2.0877698442523696,"(37.5, 52.0]",Q3
36101,2020-03-29,95796,45,2,19,8,189,2.142857142857143,2.236896261698967,"(37.5, 52.0]",Q3
36101,2020-03-30,95796,45,5,24,39,228,2.7142857142857144,2.833401931485359,"(37.5, 52.0]",Q3
36101,2020-03-31,95796,45,14,38,56,284,4.285714285714286,4.473792523397934,"(37.5, 52.0]",Q3
36101,2020-04-01,95796,45,5,43,25,309,4.571428571428571,4.77204535829113,"(37.5, 52.0]",Q3
36101,2020-04-02,95796,45,3,46,36,345,4.857142857142857,5.070298193184326,"(37.5, 52.0]",Q3
36101,2020-04-03,95796,45,9,55,27,372,6.0,6.263309532757109,"(37.5, 52.0]",Q3
36101,2020-04-04,95796,45,8,63,31,403,6.571428571428571,6.8598152025435,"(37.5, 52.0]",Q3
36101,2020-04-05,95796,45,12,75,40,443,8.0,8.351079377009478,"(37.5, 52.0]",Q3
36101,2020-04-06,95796,45,0,75,22,465,7.285714285714286,7.605447289776489,"(37.5, 52.0]",Q3
36101,2020-04-07,95796,45,7,82,67,532,6.285714285714286,6.561562367650305,"(37.5, 52.0]",Q3
36101,2020-04-08,95796,45,7,89,50,582,6.571428571428571,6.8598152025435,"(37.5, 52.0]",Q3
36101,2020-04-09,95796,45,28,117,97,679,10.142857142857142,10.587975638708446,"(37.5, 52.0]",Q3
36101,2020-04-10,95796,45,2,119,28,707,9.142857142857142,9.54409071658226,"(37.5, 52.0]",Q3
36101,2020-04-11,95796,45,2,121,12,719,8.285714285714286,8.649332211902674,"(37.5, 52.0]",Q3
36101,2020-04-12,95796,45,2,123,10,729,6.857142857142857,7.158068037436696,"(37.5, 52.0]",Q3
36101,2020-04-13,95796,45,24,147,90,819,10.285714285714286,10.737102056155043,"(37.5, 52.0]",Q3
36101,2020-04-14,95796,45,4,151,24,843,9.857142857142858,10.28972280381525,"(37.5, 52.0]",Q3
36101,2020-04-15,95796,45,3,154,20,863,9.285714285714286,9.69321713402886,"(37.5, 52.0]",Q3
36101,2020-04-16,95796,45,0,154,25,888,5.285714285714286,5.51767744552412,"(37.5, 52.0]",Q3
36101,2020-04-17,95796,45,6,160,92,980,5.857142857142857,6.114183115310511,"(37.5, 52.0]",Q3
36101,2020-04-18,95796,45,7,167,100,1080,6.571428571428571,6.8598152025435,"(37.5, 52.0]",Q3
36101,2020-04-19,95796,45,0,167,4,1084,6.285714285714286,6.561562367650305,"(37.5, 52.0]",Q3
36101,2020-04-20,95796,45,3,170,33,1117,3.2857142857142856,3.42990760127175,"(37.5, 52.0]",Q3
36101,2020-04-21,95796,45,1,171,41,1158,2.857142857142857,2.9825283489319565,"(37.5, 52.0]",Q3
36101,2020-04-22,95796,45,0,171,24,1182,2.4285714285714284,2.535149096592163,"(37.5, 52.0]",Q3
36101,2020-04-23,95796,45,0,171,28,1210,2.4285714285714284,2.535149096592163,"(37.5, 52.0]",Q3
36101,2020-04-24,95796,45,33,204,556,1766,6.285714285714286,6.561562367650305,"(37.5, 52.0]",Q3
36101,2020-04-25,95796,45,3,207,35,1801,5.714285714285714,5.965056697863913,"(37.5, 52.0]",Q3
36101,2020-04-26,95796,45,2,209,10,1811,6.0,6.263309532757109,"(37.5, 52.0]",Q3
36101,2020-04-27,95796,45,1,210,58,1869,5.714285714285714,5.965056697863913,"(37.5, 52.0]",Q3
36101,2020-04-28,95796,45,4,214,105,1974,6.142857142857143,6.412435950203706,"(37.5, 52.0]",Q3
36101,2020-04-29,95796,45,2,216,63,2037,6.428571428571429,6.710688785096903,"(37.5, 52.0]",Q3
36101,2020-04-30,95796,45,0,216,42,2079,6.428571428571429,6.710688785096903,"(37.5, 52.0]",Q3
36101,2020-05-01,95796,45,1,217,62,2141,1.8571428571428572,1.938643426805772,"(37.5, 52.0]",Q3
36101,2020-05-02,95796,45,1,218,41,2182,1.5714285714285714,1.6403905919125763,"(37.5, 52.0]",Q3
36101,2020-05-03,95796,45,1,219,70,2252,1.4285714285714286,1.4912641744659783,"(37.5, 52.0]",Q3
36101,2020-05-04,95796,45,2,221,90,2342,1.5714285714285714,1.6403905919125763,"(37.5, 52.0]",Q3
36101,2020-05-05,95796,45,2,223,114,2456,1.2857142857142858,1.3421377570193804,"(37.5, 52.0]",Q3
36101,2020-05-06,95796,45,1,224,66,2522,1.1428571428571428,1.1930113395727826,"(37.5, 52.0]",Q3
36101,2020-05-07,95796,45,1,225,101,2623,1.2857142857142858,1.3421377570193804,"(37.5, 52.0]",Q3
36101,2020-05-08,95796,45,1,226,228,2851,1.2857142857142858,1.3421377570193804,"(37.5, 52.0]",Q3
36101,2020-05-09,95796,45,1,227,73,2924,1.2857142857142858,1.3421377570193804,"(37.5, 52.0]",Q3
36101,2020-05-10,95796,45,1,228,58,2982,1.2857142857142858,1.3421377570193804,"(37.5, 52.0]",Q3
36101,2020-05-11,95796,45,1,229,90,3072,1.1428571428571428,1.1930113395727826,"(37.5, 52.0]",Q3
36101,2020-05-12,95796,45,1,230,306,3378,1.0,1.0438849221261848,"(37.5, 52.0]",Q3
36101,2020-05-13,95796,45,0,230,103,3481,0.8571428571428571,0.894758504679587,"(37.5, 52.0]",Q3
36101,2020-05-14,95796,45,1,231,110,3591,0.8571428571428571,0.894758504679587,"(37.5, 52.0]",Q3
36101,2020-05-15,95796,45,2,233,68,3659,1.0,1.0438849221261848,"(37.5, 52.0]",Q3
36101,2020-05-16,95796,45,1,234,97,3756,1.0,1.0438849221261848,"(37.5, 52.0]",Q3
36101,2020-05-17,95796,45,1,235,67,3823,1.0,1.0438849221261848,"(37.5, 52.0]",Q3
36101,2020-05-18,95796,45,1,236,126,3949,1.0,1.0438849221261848,"(37.5, 52.0]",Q3
36101,2020-05-19,95796,45,1,237,314,4263,1.0,1.0438849221261848,"(37.5, 52.0]",Q3
36101,2020-05-20,95796,45,1,238,133,4396,1.1428571428571428,1.1930113395727826,"(37.5, 52.0]",Q3
36101,2020-05-21,95796,45,2,240,161,4557,1.2857142857142858,1.3421377570193804,"(37.5, 52.0]",Q3
36101,2020-05-22,95796,45,0,240,114,4671,1.0,1.0438849221261848,"(37.5, 52.0]",Q3
36101,2020-05-23,95796,45,0,240,83,4754,0.8571428571428571,0.894758504679587,"(37.5, 52.0]",Q3
36101,2020-05-24,95796,45,0,240,72,4826,0.7142857142857143,0.7456320872329891,"(37.5, 52.0]",Q3
36101,2020-05-25,95796,45,0,240,79,4905,0.5714285714285714,0.5965056697863913,"(37.5, 52.0]",Q3
36101,2020-05-26,95796,45,1,241,221,5126,0.5714285714285714,0.5965056697863913,"(37.5, 52.0]",Q3
36101,2020-05-27,95796,45,0,241,132,5258,0.42857142857142855,0.4473792523397935,"(37.5, 52.0]",Q3
36101,2020-05-28,95796,45,0,241,98,5356,0.14285714285714285,0.14912641744659783,"(37.5, 52.0]",Q3
36101,2020-05-29,95796,45,0,241,133,5489,0.14285714285714285,0.14912641744659783,"(37.5, 52.0]",Q3
36101,2020-05-30,95796,45,0,241,122,5611,0.14285714285714285,0.14912641744659783,"(37.5, 52.0]",Q3
36101,2020-05-31,95796,45,0,241,91,5702,0.14285714285714285,0.14912641744659783,"(37.5, 52.0]",Q3
36101,2020-06-01,95796,45,1,242,133,5835,0.2857142857142857,0.29825283489319565,"(37.5, 52.0]",Q3
36101,2020-06-02,95796,45,1,243,332,6167,0.2857142857142857,0.29825283489319565,"(37.5, 52.0]",Q3
36101,2020-06-03,95796,45,2,245,187,6354,0.5714285714285714,0.5965056697863913,"(37.5, 52.0]",Q3
36101,2020-06-04,95796,45,1,246,148,6502,0.7142857142857143,0.7456320872329891,"(37.5, 52.0]",Q3
36101,2020-06-05,95796,45,5,251,360,6862,1.4285714285714286,1.4912641744659783,"(37.5, 52.0]",Q3
36101,2020-06-06,95796,45,0,251,120,6982,1.4285714285714286,1.4912641744659783,"(37.5, 52.0]",Q3
36101,2020-06-07,95796,45,0,251,162,7144,1.4285714285714286,1.4912641744659783,"(37.5, 52.0]",Q3
36103,2020-03-02,1481093,10,0,0,0,0,0.0,0.0,"(3.999, 24.0]",Q1
36103,2020-03-03,1481093,10,0,0,0,0,0.0,0.0,"(3.999, 24.0]",Q1
36103,2020-03-04,1481093,10,0,0,2,2,0.0,0.0,"(3.999, 24.0]",Q1
36103,2020-03-05,1481093,10,0,0,2,4,0.0,0.0,"(3.999, 24.0]",Q1
36103,2020-03-06,1481093,10,0,0,1,5,0.0,0.0,"(3.999, 24.0]",Q1
36103,2020-03-07,1481093,10,0,0,2,7,0.0,0.0,"(3.999, 24.0]",Q1
36103,2020-03-08,1481093,10,1,1,11,18,0.14285714285714285,0.00964538640430701,"(3.999, 24.0]",Q1
36103,2020-03-09,1481093,10,0,1,4,22,0.14285714285714285,0.00964538640430701,"(3.999, 24.0]",Q1
36103,2020-03-10,1481093,10,5,6,24,46,0.8571428571428571,0.057872318425842076,"(3.999, 24.0]",Q1
36103,2020-03-11,1481093,10,5,11,24,70,1.5714285714285714,0.10609925044737714,"(3.999, 24.0]",Q1
36103,2020-03-12,1481093,10,11,22,73,143,3.142857142857143,0.21219850089475428,"(3.999, 24.0]",Q1
36103,2020-03-13,1481093,10,10,32,79,222,4.571428571428571,0.30865236493782433,"(3.999, 24.0]",Q1
36103,2020-03-14,1481093,10,9,41,38,260,5.857142857142857,0.39546084257658753,"(3.999, 24.0]",Q1
36103,2020-03-15,1481093,10,22,63,95,355,8.857142857142858,0.5980139570670348,"(3.999, 24.0]",Q1
36103,2020-03-16,1481093,10,22,85,109,464,12.0,0.8102124579617891,"(3.999, 24.0]",Q1
36103,2020-03-17,1481093,10,31,116,179,643,15.714285714285714,1.0609925044737714,"(3.999, 24.0]",Q1
36103,2020-03-18,1481093,10,62,178,361,1004,23.857142857142858,1.610779529519271,"(3.999, 24.0]",Q1
36103,2020-03-19,1481093,10,193,371,766,1770,49.857142857142854,3.3662398551031467,"(3.999, 24.0]",Q1
36103,2020-03-20,1481093,10,290,661,1461,3231,89.85714285714286,6.066948048309111,"(3.999, 24.0]",Q1
36103,2020-03-21,1481093,10,373,1034,1578,4809,141.85714285714286,9.577868699476864,"(3.999, 24.0]",Q1
36103,2020-03-22,1481093,10,424,1458,1153,5962,199.28571428571428,13.455314034008282,"(3.999, 24.0]",Q1
36103,2020-03-23,1481093,10,422,1880,1047,7009,256.42857142857144,17.313468595731088,"(3.999, 24.0]",Q1
36103,2020-03-24,1481093,10,380,2260,854,7863,306.2857142857143,20.679708450834234,"(3.999, 24.0]",Q1
36103,2020-03-25,1481093,10,475,2735,1189,9052,365.2857142857143,24.663253035813028,"(3.999, 24.0]",Q1
36103,2020-03-26,1481093,10,650,3385,1333,10385,430.57142857142856,29.071194622581334,"(3.999, 24.0]",Q1
36103,2020-03-27,1481093,10,753,4138,1690,12075,496.7142857142857,33.537008527775484,"(3.999, 24.0]",Q1
36103,2020-03-28,1481093,10,885,5023,2155,14230,569.8571428571429,38.47544636678067,"(3.999, 24.0]",Q1
36103,2020-03-29,1481093,10,768,5791,1598,15828,619.0,41.793459289862284,"(3.999, 24.0]",Q1
36103,2020-03-30,1481093,10,922,6713,1857,17685,690.4285714285714,46.616152492015786,"(3.999, 24.0]",Q1
36103,2020-03-31,1481093,10,892,7605,1620,19305,763.5714285714286,51.55459033102098,"(3.999, 24.0]",Q1
36103,2020-04-01,1481093,10,1141,8746,2148,21453,858.7142857142857,57.978417676289446,"(3.999, 24.0]",Q1
36103,2020-04-02,1481093,10,1408,10154,2575,24028,967.0,65.28962057075417,"(3.999, 24.0]",Q1
36103,2020-04-03,1481093,10,1216,11370,2463,26491,1033.142857142857,69.7554344759483,"(3.999, 24.0]",Q1
36103,2020-04-04,1481093,10,1035,12405,2200,28691,1054.5714285714287,71.20224243659437,"(3.999, 24.0]",Q1
36103,2020-04-05,1481093,10,1082,13487,2211,30902,1099.4285714285713,74.23089376754676,"(3.999, 24.0]",Q1
36103,2020-04-06,1481093,10,1030,14517,2323,33225,1114.857142857143,75.27259549921192,"(3.999, 24.0]",Q1
36103,2020-04-07,1481093,10,1327,15844,3139,36364,1177.0,79.46833858508548,"(3.999, 24.0]",Q1
36103,2020-04-08,1481093,10,1569,17413,3889,40253,1238.142857142857,83.59656396612887,"(3.999, 24.0]",Q1
36103,2020-04-09,1481093,10,1279,18692,2942,43195,1219.7142857142858,82.35230911997327,"(3.999, 24.0]",Q1
36103,2020-04-10,1481093,10,1191,19883,2556,45751,1216.142857142857,82.1111744598656,"(3.999, 24.0]",Q1
36103,2020-04-11,1481093,10,933,20816,2215,47966,1201.5714285714287,81.12734504662629,"(3.999, 24.0]",Q1
36103,2020-04-12,1481093,10,827,21643,2164,50130,1165.142857142857,78.667771513528,"(3.999, 24.0]",Q1
36103,2020-04-13,1481093,10,819,22462,2246,52376,1135.0,76.63259498221922,"(3.999, 24.0]",Q1
36103,2020-04-14,1481093,10,816,23278,2135,54511,1062.0,71.70380252961833,"(3.999, 24.0]",Q1
36103,2020-04-15,1481093,10,904,24182,2536,57047,967.0,65.28962057075417,"(3.999, 24.0]",Q1
36103,2020-04-16,1481093,10,853,25035,2496,59543,906.1428571428571,61.18068596251937,"(3.999, 24.0]",Q1
36103,2020-04-17,1481093,10,1108,26143,3385,62928,894.2857142857143,60.3801188909619,"(3.999, 24.0]",Q1
36103,2020-04-18,1481093,10,745,26888,2392,65320,867.4285714285714,58.566786246952184,"(3.999, 24.0]",Q1
36103,2020-04-19,1481093,10,774,27662,2278,67598,859.8571428571429,58.05558076752391,"(3.999, 24.0]",Q1
36103,2020-04-20,1481093,10,492,28154,1482,69080,813.1428571428571,54.901539413315504,"(3.999, 24.0]",Q1
36103,2020-04-21,1481093,10,700,28854,2188,71268,796.5714285714286,53.7826745904159,"(3.999, 24.0]",Q1
36103,2020-04-22,1481093,10,713,29567,2428,73696,769.2857142857143,51.940405787193264,"(3.999, 24.0]",Q1
36103,2020-04-23,1481093,10,1039,30606,3858,77554,795.8571428571429,53.734447658394366,"(3.999, 24.0]",Q1
36103,2020-04-24,1481093,10,762,31368,2860,80414,746.4285714285714,50.397143962504146,"(3.999, 24.0]",Q1
36103,2020-04-25,1481093,10,691,32059,2830,83244,738.7142857142857,49.87629309667155,"(3.999, 24.0]",Q1
36103,2020-04-26,1481093,10,411,32470,1826,85070,686.8571428571429,46.37501783190812,"(3.999, 24.0]",Q1
36103,2020-04-27,1481093,10,254,32724,1429,86499,652.8571428571429,44.079415867683046,"(3.999, 24.0]",Q1
36103,2020-04-28,1481093,10,541,33265,2669,89168,630.1428571428571,42.54579942939823,"(3.999, 24.0]",Q1
36103,2020-04-29,1481093,10,399,33664,2193,91361,585.2857142857143,39.51714809844583,"(3.999, 24.0]",Q1
36103,2020-04-30,1481093,10,373,34037,2207,93568,490.14285714285717,33.09332075317736,"(3.999, 24.0]",Q1
36103,2020-05-01,1481093,10,441,34478,2660,96228,444.2857142857143,29.99715171739481,"(3.999, 24.0]",Q1
36103,2020-05-02,1481093,10,377,34855,2521,98749,399.42857142857144,26.968500386442404,"(3.999, 24.0]",Q1
36103,2020-05-03,1481093,10,222,35077,1640,100389,372.42857142857144,25.145522356028383,"(3.999, 24.0]",Q1
36103,2020-05-04,1481093,10,198,35275,1586,101975,364.42857142857144,24.605380717387188,"(3.999, 24.0]",Q1
36103,2020-05-05,1481093,10,268,35543,2112,104087,325.42857142857144,21.972190229011375,"(3.999, 24.0]",Q1
36103,2020-05-06,1481093,10,349,35892,2668,106755,318.2857142857143,21.489920908796023,"(3.999, 24.0]",Q1
36103,2020-05-07,1481093,10,331,36223,2357,109112,312.2857142857143,21.08481467981513,"(3.999, 24.0]",Q1
36103,2020-05-08,1481093,10,238,36461,2227,111339,283.2857142857143,19.126801239740804,"(3.999, 24.0]",Q1
36103,2020-05-09,1481093,10,241,36702,2556,113895,263.85714285714283,17.81502868875505,"(3.999, 24.0]",Q1
36103,2020-05-10,1481093,10,209,36911,2014,115909,262.0,17.68963866549906,"(3.999, 24.0]",Q1
36103,2020-05-11,1481093,10,151,37062,1964,117873,255.28571428571428,17.23630550449663,"(3.999, 24.0]",Q1
36103,2020-05-12,1481093,10,243,37305,2950,120823,251.71428571428572,16.99517084438896,"(3.999, 24.0]",Q1
36103,2020-05-13,1481093,10,239,37544,3229,124052,236.0,15.934178339915185,"(3.999, 24.0]",Q1
36103,2020-05-14,1481093,10,175,37719,2777,126829,213.71428571428572,14.429498060843292,"(3.999, 24.0]",Q1
36103,2020-05-15,1481093,10,223,37942,3048,129877,211.57142857142858,14.284817264778685,"(3.999, 24.0]",Q1
36103,2020-05-16,1481093,10,175,38117,2818,132695,202.14285714285714,13.64822176209442,"(3.999, 24.0]",Q1
36103,2020-05-17,1481093,10,107,38224,1948,134643,187.57142857142858,12.664392348855108,"(3.999, 24.0]",Q1
36103,2020-05-18,1481093,10,103,38327,2118,136761,180.71428571428572,12.201413801448371,"(3.999, 24.0]",Q1
36103,2020-05-19,1481093,10,84,38411,2416,139177,158.0,10.667797363163556,"(3.999, 24.0]",Q1
36103,2020-05-20,1481093,10,142,38553,3623,142800,144.14285714285714,9.732194881945775,"(3.999, 24.0]",Q1
36103,2020-05-21,1481093,10,119,38672,3022,145822,136.14285714285714,9.192053243304583,"(3.999, 24.0]",Q1
36103,2020-05-22,1481093,10,130,38802,4005,149827,122.85714285714286,8.29503230770403,"(3.999, 24.0]",Q1
36103,2020-05-23,1481093,10,162,38964,3865,153692,121.0,8.169642284448038,"(3.999, 24.0]",Q1
36103,2020-05-24,1481093,10,126,39090,4010,157702,123.71428571428571,8.352904626129872,"(3.999, 24.0]",Q1
36103,2020-05-25,1481093,10,109,39199,3241,160943,124.57142857142857,8.410776944555714,"(3.999, 24.0]",Q1
36103,2020-05-26,1481093,10,59,39258,2492,163435,121.0,8.169642284448038,"(3.999, 24.0]",Q1
36103,2020-05-27,1481093,10,101,39359,4482,167917,115.14285714285714,7.774181441871452,"(3.999, 24.0]",Q1
36103,2020-05-28,1481093,10,86,39445,4591,172508,110.42857142857143,7.455883690529321,"(3.999, 24.0]",Q1
36103,2020-05-29,1481093,10,87,39532,4388,176896,104.28571428571429,7.0411320751441195,"(3.999, 24.0]",Q1
36103,2020-05-30,1481093,10,111,39643,5138,182034,97.0,6.549217368524461,"(3.999, 24.0]",Q1
36103,2020-05-31,1481093,10,62,39705,4294,186328,87.85714285714286,5.931912638648813,"(3.999, 24.0]",Q1
36103,2020-06-01,1481093,10,275,39980,4365,190693,111.57142857142857,7.533046781763776,"(3.999, 24.0]",Q1
36103,2020-06-02,1481093,10,82,40062,4840,195533,114.85714285714286,7.754890669062838,"(3.999, 24.0]",Q1
36103,2020-06-03,1481093,10,91,40153,5178,200711,113.42857142857143,7.658436805019768,"(3.999, 24.0]",Q1
36103,2020-06-04,1481093,10,86,40239,5202,205913,113.42857142857143,7.658436805019768,"(3.999, 24.0]",Q1
36103,2020-06-05,1481093,10,39,40278,5505,211418,106.57142857142857,7.195458257613031,"(3.999, 24.0]",Q1
36103,2020-06-06,1481093,10,51,40329,4582,216000,98.0,6.616735073354611,"(3.999, 24.0]",Q1
36103,2020-06-07,1481093,10,48,40377,4833,220833,96.0,6.481699663694313,"(3.999, 24.0]",Q1
36105,2020-03-02,75498,68,0,0,0,0,0.0,0.0,"(52.0, 100.0]",Q4
36105,2020-03-03,75498,68,0,0,0,0,0.0,0.0,"(52.0, 100.0]",Q4
36105,2020-03-04,75498,68,0,0,0,0,0.0,0.0,"(52.0, 100.0]",Q4
36105,2020-03-05,75498,68,0,0,0,0,0.0,0.0,"(52.0, 100.0]",Q4
36105,2020-03-06,75498,68,0,0,0,0,0.0,0.0,"(52.0, 100.0]",Q4
36105,2020-03-07,75498,68,0,0,0,0,0.0,0.0,"(52.0, 100.0]",Q4
36105,2020-03-08,75498,68,0,0,0,0,0.0,0.0,"(52.0, 100.0]",Q4
36105,2020-03-09,75498,68,0,0,0,0,0.0,0.0,"(52.0, 100.0]",Q4
36105,2020-03-10,75498,68,0,0,0,0,0.0,0.0,"(52.0, 100.0]",Q4
36105,2020-03-11,75498,68,0,0,1,1,0.0,0.0,"(52.0, 100.0]",Q4
36105,2020-03-12,75498,68,0,0,0,1,0.0,0.0,"(52.0, 100.0]",Q4
36105,2020-03-13,75498,68,0,0,1,2,0.0,0.0,"(52.0, 100.0]",Q4
36105,2020-03-14,75498,68,0,0,7,9,0.0,0.0,"(52.0, 100.0]",Q4
36105,2020-03-15,75498,68,0,0,2,11,0.0,0.0,"(52.0, 100.0]",Q4
36105,2020-03-16,75498,68,1,1,9,20,0.14285714285714285,0.18921977119545266,"(52.0, 100.0]",Q4
36105,2020-03-17,75498,68,0,1,14,34,0.14285714285714285,0.18921977119545266,"(52.0, 100.0]",Q4
36105,2020-03-18,75498,68,2,3,23,57,0.42857142857142855,0.567659313586358,"(52.0, 100.0]",Q4
36105,2020-03-19,75498,68,5,8,79,136,1.1428571428571428,1.5137581695636213,"(52.0, 100.0]",Q4
36105,2020-03-20,75498,68,4,12,42,178,1.7142857142857142,2.270637254345432,"(52.0, 100.0]",Q4
36105,2020-03-21,75498,68,4,16,37,215,2.2857142857142856,3.0275163391272426,"(52.0, 100.0]",Q4
36105,2020-03-22,75498,68,7,23,83,298,3.2857142857142856,4.352054737495411,"(52.0, 100.0]",Q4
36105,2020-03-23,75498,68,7,30,44,342,4.142857142857143,5.487373364668128,"(52.0, 100.0]",Q4
36105,2020-03-24,75498,68,9,39,23,365,5.428571428571429,7.190351305427202,"(52.0, 100.0]",Q4
36105,2020-03-25,75498,68,14,53,53,418,7.142857142857143,9.460988559772634,"(52.0, 100.0]",Q4
36105,2020-03-26,75498,68,11,64,62,480,8.0,10.59630718694535,"(52.0, 100.0]",Q4
36105,2020-03-27,75498,68,8,72,49,529,8.571428571428571,11.353186271727159,"(52.0, 100.0]",Q4
36105,2020-03-28,75498,68,16,88,91,620,10.285714285714286,13.623823526072595,"(52.0, 100.0]",Q4
36105,2020-03-29,75498,68,13,101,53,673,11.142857142857142,14.759142153245307,"(52.0, 100.0]",Q4
36105,2020-03-30,75498,68,8,109,33,706,11.285714285714286,14.948361924440762,"(52.0, 100.0]",Q4
36105,2020-03-31,75498,68,12,121,55,761,11.714285714285714,15.516021238027118,"(52.0, 100.0]",Q4
36105,2020-04-01,75498,68,22,143,96,857,12.857142857142858,17.02977940759074,"(52.0, 100.0]",Q4
36105,2020-04-02,75498,68,25,168,140,997,14.857142857142858,19.678856204327076,"(52.0, 100.0]",Q4
36105,2020-04-03,75498,68,25,193,133,1130,17.285714285714285,22.89559231464977,"(52.0, 100.0]",Q4
36105,2020-04-04,75498,68,41,234,153,1283,20.857142857142858,27.62608659453609,"(52.0, 100.0]",Q4
36105,2020-04-05,75498,68,19,253,91,1374,21.714285714285715,28.76140522170881,"(52.0, 100.0]",Q4
36105,2020-04-06,75498,68,17,270,77,1451,23.0,30.46438316246788,"(52.0, 100.0]",Q4
36105,2020-04-07,75498,68,9,279,56,1507,22.571428571428573,29.896723848881525,"(52.0, 100.0]",Q4
36105,2020-04-08,75498,68,15,294,60,1567,21.571428571428573,28.572185450513356,"(52.0, 100.0]",Q4
36105,2020-04-09,75498,68,24,318,115,1682,21.428571428571427,28.382965679317895,"(52.0, 100.0]",Q4
36105,2020-04-10,75498,68,22,340,99,1781,21.0,27.815306365731544,"(52.0, 100.0]",Q4
36105,2020-04-11,75498,68,18,358,65,1846,17.714285714285715,23.463251628236133,"(52.0, 100.0]",Q4
36105,2020-04-12,75498,68,22,380,73,1919,18.142857142857142,24.030910941822487,"(52.0, 100.0]",Q4
36105,2020-04-13,75498,68,35,415,133,2052,20.714285714285715,27.436866823340637,"(52.0, 100.0]",Q4
36105,2020-04-14,75498,68,9,424,37,2089,20.714285714285715,27.436866823340637,"(52.0, 100.0]",Q4
36105,2020-04-15,75498,68,13,437,39,2128,20.428571428571427,27.05842728094973,"(52.0, 100.0]",Q4
36105,2020-04-16,75498,68,68,505,192,2320,26.714285714285715,35.38409721354965,"(52.0, 100.0]",Q4
36105,2020-04-17,75498,68,19,524,92,2412,26.285714285714285,34.81643789996329,"(52.0, 100.0]",Q4
36105,2020-04-18,75498,68,13,537,38,2450,25.571428571428573,33.87033904398603,"(52.0, 100.0]",Q4
36105,2020-04-19,75498,68,7,544,30,2480,23.428571428571427,31.032042476054237,"(52.0, 100.0]",Q4
36105,2020-04-20,75498,68,11,555,44,2524,20.0,26.49076796736337,"(52.0, 100.0]",Q4
36105,2020-04-21,75498,68,6,561,45,2569,19.571428571428573,25.923108653777017,"(52.0, 100.0]",Q4
36105,2020-04-22,75498,68,19,580,52,2621,20.428571428571427,27.05842728094973,"(52.0, 100.0]",Q4
36105,2020-04-23,75498,68,48,628,253,2874,17.571428571428573,23.274031857040683,"(52.0, 100.0]",Q4
36105,2020-04-24,75498,68,61,689,296,3170,23.571428571428573,31.22126224724969,"(52.0, 100.0]",Q4
36105,2020-04-25,75498,68,35,724,160,3330,26.714285714285715,35.38409721354965,"(52.0, 100.0]",Q4
36105,2020-04-26,75498,68,24,748,120,3450,29.142857142857142,38.600833323872344,"(52.0, 100.0]",Q4
36105,2020-04-27,75498,68,21,769,77,3527,30.571428571428573,40.493031035826874,"(52.0, 100.0]",Q4
36105,2020-04-28,75498,68,42,811,114,3641,35.714285714285715,47.304942798863166,"(52.0, 100.0]",Q4
36105,2020-04-29,75498,68,27,838,102,3743,36.857142857142854,48.81870096842678,"(52.0, 100.0]",Q4
36105,2020-04-30,75498,68,42,880,122,3865,36.0,47.683382341254074,"(52.0, 100.0]",Q4
36105,2020-05-01,75498,68,51,931,128,3993,34.57142857142857,45.79118462929954,"(52.0, 100.0]",Q4
36105,2020-05-02,75498,68,20,951,105,4098,32.42857142857143,42.95288806136776,"(52.0, 100.0]",Q4
36105,2020-05-03,75498,68,25,976,106,4204,32.57142857142857,43.142107832563205,"(52.0, 100.0]",Q4
36105,2020-05-04,75498,68,8,984,111,4315,30.714285714285715,40.68225080702233,"(52.0, 100.0]",Q4
36105,2020-05-05,75498,68,12,996,99,4414,26.428571428571427,35.005657671158744,"(52.0, 100.0]",Q4
36105,2020-05-06,75498,68,25,1021,150,4564,26.142857142857142,34.627218128767836,"(52.0, 100.0]",Q4
36105,2020-05-07,75498,68,18,1039,90,4654,22.714285714285715,30.085943620076975,"(52.0, 100.0]",Q4
36105,2020-05-08,75498,68,32,1071,143,4797,20.0,26.49076796736337,"(52.0, 100.0]",Q4
36105,2020-05-09,75498,68,22,1093,115,4912,20.285714285714285,26.86920750975428,"(52.0, 100.0]",Q4
36105,2020-05-10,75498,68,16,1109,78,4990,19.0,25.166229568995206,"(52.0, 100.0]",Q4
36105,2020-05-11,75498,68,10,1119,95,5085,19.285714285714285,25.544669111386106,"(52.0, 100.0]",Q4
36105,2020-05-12,75498,68,16,1135,89,5174,19.857142857142858,26.301548196167925,"(52.0, 100.0]",Q4
36105,2020-05-13,75498,68,33,1168,178,5352,21.0,27.815306365731544,"(52.0, 100.0]",Q4
36105,2020-05-14,75498,68,21,1189,127,5479,21.428571428571427,28.382965679317895,"(52.0, 100.0]",Q4
36105,2020-05-15,75498,68,28,1217,176,5655,20.857142857142858,27.62608659453609,"(52.0, 100.0]",Q4
36105,2020-05-16,75498,68,14,1231,138,5793,19.714285714285715,26.11232842497247,"(52.0, 100.0]",Q4
36105,2020-05-17,75498,68,15,1246,133,5926,19.571428571428573,25.923108653777017,"(52.0, 100.0]",Q4
36105,2020-05-18,75498,68,12,1258,111,6037,19.857142857142858,26.301548196167925,"(52.0, 100.0]",Q4
36105,2020-05-19,75498,68,9,1267,116,6153,18.857142857142858,24.977009797799752,"(52.0, 100.0]",Q4
36105,2020-05-20,75498,68,14,1281,157,6310,16.142857142857142,21.381834145086152,"(52.0, 100.0]",Q4
36105,2020-05-21,75498,68,6,1287,158,6468,14.0,18.54353757715436,"(52.0, 100.0]",Q4
36105,2020-05-22,75498,68,10,1297,148,6616,11.428571428571429,15.137581695636213,"(52.0, 100.0]",Q4
36105,2020-05-23,75498,68,13,1310,155,6771,11.285714285714286,14.948361924440762,"(52.0, 100.0]",Q4
36105,2020-05-24,75498,68,14,1324,170,6941,11.142857142857142,14.759142153245307,"(52.0, 100.0]",Q4
36105,2020-05-25,75498,68,14,1338,238,7179,11.428571428571429,15.137581695636213,"(52.0, 100.0]",Q4
36105,2020-05-26,75498,68,2,1340,77,7256,10.428571428571429,13.813043297268045,"(52.0, 100.0]",Q4
36105,2020-05-27,75498,68,11,1351,209,7465,10.0,13.245383983681686,"(52.0, 100.0]",Q4
36105,2020-05-28,75498,68,13,1364,160,7625,11.0,14.569922382049857,"(52.0, 100.0]",Q4
36105,2020-05-29,75498,68,11,1375,254,7879,11.142857142857142,14.759142153245307,"(52.0, 100.0]",Q4
36105,2020-05-30,75498,68,12,1387,237,8116,11.0,14.569922382049857,"(52.0, 100.0]",Q4
36105,2020-05-31,75498,68,2,1389,145,8261,9.285714285714286,12.299285127704424,"(52.0, 100.0]",Q4
36105,2020-06-01,75498,68,3,1392,108,8369,7.714285714285714,10.217867644554445,"(52.0, 100.0]",Q4
36105,2020-06-02,75498,68,1,1393,155,8524,7.571428571428571,10.028647873358992,"(52.0, 100.0]",Q4
36105,2020-06-03,75498,68,12,1405,186,8710,7.714285714285714,10.217867644554445,"(52.0, 100.0]",Q4
36105,2020-06-04,75498,68,4,1409,167,8877,6.428571428571429,8.51488970379537,"(52.0, 100.0]",Q4
36105,2020-06-05,75498,68,2,1411,176,9053,5.142857142857143,6.8119117630362975,"(52.0, 100.0]",Q4
36105,2020-06-06,75498,68,4,1415,177,9230,4.0,5.298153593472675,"(52.0, 100.0]",Q4
36105,2020-06-07,75498,68,2,1417,123,9353,4.0,5.298153593472675,"(52.0, 100.0]",Q4
36107,2020-03-02,48560,11,0,0,0,0,0.0,0.0,"(3.999, 24.0]",Q1
36107,2020-03-03,48560,11,0,0,0,0,0.0,0.0,"(3.999, 24.0]",Q1
36107,2020-03-04,48560,11,0,0,0,0,0.0,0.0,"(3.999, 24.0]",Q1
36107,2020-03-05,48560,11,0,0,0,0,0.0,0.0,"(3.999, 24.0]",Q1
36107,2020-03-06,48560,11,0,0,0,0,0.0,0.0,"(3.999, 24.0]",Q1
36107,2020-03-07,48560,11,0,0,0,0,0.0,0.0,"(3.999, 24.0]",Q1
36107,2020-03-08,48560,11,0,0,0,0,0.0,0.0,"(3.999, 24.0]",Q1
36107,2020-03-09,48560,11,0,0,0,0,0.0,0.0,"(3.999, 24.0]",Q1
36107,2020-03-10,48560,11,0,0,0,0,0.0,0.0,"(3.999, 24.0]",Q1
36107,2020-03-11,48560,11,0,0,1,1,0.0,0.0,"(3.999, 24.0]",Q1
36107,2020-03-12,48560,11,0,0,0,1,0.0,0.0,"(3.999, 24.0]",Q1
36107,2020-03-13,48560,11,1,1,1,2,0.14285714285714285,0.29418686749823486,"(3.999, 24.0]",Q1
36107,2020-03-14,48560,11,0,1,0,2,0.14285714285714285,0.29418686749823486,"(3.999, 24.0]",Q1
36107,2020-03-15,48560,11,0,1,1,3,0.14285714285714285,0.29418686749823486,"(3.999, 24.0]",Q1
36107,2020-03-16,48560,11,0,1,3,6,0.14285714285714285,0.29418686749823486,"(3.999, 24.0]",Q1
36107,2020-03-17,48560,11,0,1,5,11,0.14285714285714285,0.29418686749823486,"(3.999, 24.0]",Q1
36107,2020-03-18,48560,11,0,1,0,11,0.14285714285714285,0.29418686749823486,"(3.999, 24.0]",Q1
36107,2020-03-19,48560,11,0,1,0,11,0.14285714285714285,0.29418686749823486,"(3.999, 24.0]",Q1
36107,2020-03-20,48560,11,0,1,5,16,0.0,0.0,"(3.999, 24.0]",Q1
36107,2020-03-21,48560,11,0,1,4,20,0.0,0.0,"(3.999, 24.0]",Q1
36107,2020-03-22,48560,11,0,1,4,24,0.0,0.0,"(3.999, 24.0]",Q1
36107,2020-03-23,48560,11,0,1,3,27,0.0,0.0,"(3.999, 24.0]",Q1
36107,2020-03-24,48560,11,0,1,1,28,0.0,0.0,"(3.999, 24.0]",Q1
36107,2020-03-25,48560,11,1,2,12,40,0.14285714285714285,0.29418686749823486,"(3.999, 24.0]",Q1
36107,2020-03-26,48560,11,0,2,10,50,0.14285714285714285,0.29418686749823486,"(3.999, 24.0]",Q1
36107,2020-03-27,48560,11,2,4,18,68,0.42857142857142855,0.8825606024947045,"(3.999, 24.0]",Q1
36107,2020-03-28,48560,11,0,4,21,89,0.42857142857142855,0.8825606024947045,"(3.999, 24.0]",Q1
36107,2020-03-29,48560,11,0,4,15,104,0.42857142857142855,0.8825606024947045,"(3.999, 24.0]",Q1
36107,2020-03-30,48560,11,3,7,21,125,0.8571428571428571,1.765121204989409,"(3.999, 24.0]",Q1
36107,2020-03-31,48560,11,0,7,15,140,0.8571428571428571,1.765121204989409,"(3.999, 24.0]",Q1
36107,2020-04-01,48560,11,0,7,14,154,0.7142857142857143,1.4709343374911743,"(3.999, 24.0]",Q1
36107,2020-04-02,48560,11,0,7,18,172,0.7142857142857143,1.4709343374911743,"(3.999, 24.0]",Q1
36107,2020-04-03,48560,11,0,7,9,181,0.42857142857142855,0.8825606024947045,"(3.999, 24.0]",Q1
36107,2020-04-04,48560,11,0,7,8,189,0.42857142857142855,0.8825606024947045,"(3.999, 24.0]",Q1
36107,2020-04-05,48560,11,1,8,10,199,0.5714285714285714,1.1767474699929394,"(3.999, 24.0]",Q1
36107,2020-04-06,48560,11,0,8,10,209,0.14285714285714285,0.29418686749823486,"(3.999, 24.0]",Q1
36107,2020-04-07,48560,11,4,12,29,238,0.7142857142857143,1.4709343374911743,"(3.999, 24.0]",Q1
36107,2020-04-08,48560,11,5,17,32,270,1.4285714285714286,2.9418686749823486,"(3.999, 24.0]",Q1
36107,2020-04-09,48560,11,1,18,16,286,1.5714285714285714,3.2360555424805835,"(3.999, 24.0]",Q1
36107,2020-04-10,48560,11,1,19,10,296,1.7142857142857142,3.530242409978818,"(3.999, 24.0]",Q1
36107,2020-04-11,48560,11,0,19,8,304,1.7142857142857142,3.530242409978818,"(3.999, 24.0]",Q1
36107,2020-04-12,48560,11,1,20,3,307,1.7142857142857142,3.530242409978818,"(3.999, 24.0]",Q1
36107,2020-04-13,48560,11,4,24,52,359,2.2857142857142856,4.706989879971758,"(3.999, 24.0]",Q1
36107,2020-04-14,48560,11,1,25,14,373,1.8571428571428572,3.8244292774770536,"(3.999, 24.0]",Q1
36107,2020-04-15,48560,11,2,27,16,389,1.4285714285714286,2.9418686749823486,"(3.999, 24.0]",Q1
36107,2020-04-16,48560,11,3,30,13,402,1.7142857142857142,3.530242409978818,"(3.999, 24.0]",Q1
36107,2020-04-17,48560,11,2,32,16,418,1.8571428571428572,3.8244292774770536,"(3.999, 24.0]",Q1
36107,2020-04-18,48560,11,3,35,10,428,2.2857142857142856,4.706989879971758,"(3.999, 24.0]",Q1
36107,2020-04-19,48560,11,2,37,6,434,2.4285714285714284,5.001176747469993,"(3.999, 24.0]",Q1
36107,2020-04-20,48560,11,0,37,5,439,1.8571428571428572,3.8244292774770536,"(3.999, 24.0]",Q1
36107,2020-04-21,48560,11,2,39,10,449,2.0,4.118616144975288,"(3.999, 24.0]",Q1
36107,2020-04-22,48560,11,1,40,13,462,1.8571428571428572,3.8244292774770536,"(3.999, 24.0]",Q1
36107,2020-04-23,48560,11,0,40,10,472,1.4285714285714286,2.9418686749823486,"(3.999, 24.0]",Q1
36107,2020-04-24,48560,11,31,71,173,645,5.571428571428571,11.47328783243116,"(3.999, 24.0]",Q1
36107,2020-04-25,48560,11,0,71,8,653,5.142857142857143,10.590727229936457,"(3.999, 24.0]",Q1
36107,2020-04-26,48560,11,0,71,8,661,4.857142857142857,10.002353494939985,"(3.999, 24.0]",Q1
36107,2020-04-27,48560,11,11,82,86,747,6.428571428571429,13.238409037420569,"(3.999, 24.0]",Q1
36107,2020-04-28,48560,11,2,84,68,815,6.428571428571429,13.238409037420569,"(3.999, 24.0]",Q1
36107,2020-04-29,48560,11,4,88,69,884,6.857142857142857,14.120969639915272,"(3.999, 24.0]",Q1
36107,2020-04-30,48560,11,2,90,19,903,7.142857142857143,14.709343374911745,"(3.999, 24.0]",Q1
36107,2020-05-01,48560,11,0,90,20,923,2.7142857142857144,5.589550482466462,"(3.999, 24.0]",Q1
36107,2020-05-02,48560,11,0,90,25,948,2.7142857142857144,5.589550482466462,"(3.999, 24.0]",Q1
36107,2020-05-03,48560,11,0,90,50,998,2.7142857142857144,5.589550482466462,"(3.999, 24.0]",Q1
36107,2020-05-04,48560,11,2,92,67,1065,1.4285714285714286,2.9418686749823486,"(3.999, 24.0]",Q1
36107,2020-05-05,48560,11,4,96,76,1141,1.7142857142857142,3.530242409978818,"(3.999, 24.0]",Q1
36107,2020-05-06,48560,11,1,97,40,1181,1.2857142857142858,2.647681807484114,"(3.999, 24.0]",Q1
36107,2020-05-07,48560,11,2,99,40,1221,1.2857142857142858,2.647681807484114,"(3.999, 24.0]",Q1
36107,2020-05-08,48560,11,5,104,83,1304,2.0,4.118616144975288,"(3.999, 24.0]",Q1
36107,2020-05-09,48560,11,1,105,31,1335,2.142857142857143,4.412803012473523,"(3.999, 24.0]",Q1
36107,2020-05-10,48560,11,2,107,40,1375,2.4285714285714284,5.001176747469993,"(3.999, 24.0]",Q1
36107,2020-05-11,48560,11,0,107,35,1410,2.142857142857143,4.412803012473523,"(3.999, 24.0]",Q1
36107,2020-05-12,48560,11,1,108,92,1502,1.7142857142857142,3.530242409978818,"(3.999, 24.0]",Q1
36107,2020-05-13,48560,11,0,108,59,1561,1.5714285714285714,3.2360555424805835,"(3.999, 24.0]",Q1
36107,2020-05-14,48560,11,2,110,42,1603,1.5714285714285714,3.2360555424805835,"(3.999, 24.0]",Q1
36107,2020-05-15,48560,11,2,112,57,1660,1.1428571428571428,2.353494939985879,"(3.999, 24.0]",Q1
36107,2020-05-16,48560,11,1,113,59,1719,1.1428571428571428,2.353494939985879,"(3.999, 24.0]",Q1
36107,2020-05-17,48560,11,0,113,82,1801,0.8571428571428571,1.765121204989409,"(3.999, 24.0]",Q1
36107,2020-05-18,48560,11,0,113,113,1914,0.8571428571428571,1.765121204989409,"(3.999, 24.0]",Q1
36107,2020-05-19,48560,11,1,114,106,2020,0.8571428571428571,1.765121204989409,"(3.999, 24.0]",Q1
36107,2020-05-20,48560,11,3,117,89,2109,1.2857142857142858,2.647681807484114,"(3.999, 24.0]",Q1
36107,2020-05-21,48560,11,1,118,105,2214,1.1428571428571428,2.353494939985879,"(3.999, 24.0]",Q1
36107,2020-05-22,48560,11,3,121,96,2310,1.2857142857142858,2.647681807484114,"(3.999, 24.0]",Q1
36107,2020-05-23,48560,11,1,122,79,2389,1.2857142857142858,2.647681807484114,"(3.999, 24.0]",Q1
36107,2020-05-24,48560,11,0,122,54,2443,1.2857142857142858,2.647681807484114,"(3.999, 24.0]",Q1
36107,2020-05-25,48560,11,0,122,45,2488,1.2857142857142858,2.647681807484114,"(3.999, 24.0]",Q1
36107,2020-05-26,48560,11,2,124,195,2683,1.4285714285714286,2.9418686749823486,"(3.999, 24.0]",Q1
36107,2020-05-27,48560,11,2,126,132,2815,1.2857142857142858,2.647681807484114,"(3.999, 24.0]",Q1
36107,2020-05-28,48560,11,0,126,110,2925,1.1428571428571428,2.353494939985879,"(3.999, 24.0]",Q1
36107,2020-05-29,48560,11,2,128,141,3066,1.0,2.059308072487644,"(3.999, 24.0]",Q1
36107,2020-05-30,48560,11,2,130,107,3173,1.1428571428571428,2.353494939985879,"(3.999, 24.0]",Q1
36107,2020-05-31,48560,11,0,130,44,3217,1.1428571428571428,2.353494939985879,"(3.999, 24.0]",Q1
36107,2020-06-01,48560,11,1,131,143,3360,1.2857142857142858,2.647681807484114,"(3.999, 24.0]",Q1
36107,2020-06-02,48560,11,2,133,123,3483,1.2857142857142858,2.647681807484114,"(3.999, 24.0]",Q1
36107,2020-06-03,48560,11,0,133,101,3584,1.0,2.059308072487644,"(3.999, 24.0]",Q1
36107,2020-06-04,48560,11,1,134,140,3724,1.1428571428571428,2.353494939985879,"(3.999, 24.0]",Q1
36107,2020-06-05,48560,11,0,134,302,4026,0.8571428571428571,1.765121204989409,"(3.999, 24.0]",Q1
36107,2020-06-06,48560,11,0,134,146,4172,0.5714285714285714,1.1767474699929394,"(3.999, 24.0]",Q1
36107,2020-06-07,48560,11,0,134,79,4251,0.5714285714285714,1.1767474699929394,"(3.999, 24.0]",Q1
36109,2020-03-02,102793,47,0,0,0,0,0.0,0.0,"(37.5, 52.0]",Q3
36109,2020-03-03,102793,47,0,0,0,0,0.0,0.0,"(37.5, 52.0]",Q3
36109,2020-03-04,102793,47,0,0,0,0,0.0,0.0,"(37.5, 52.0]",Q3
36109,2020-03-05,102793,47,0,0,0,0,0.0,0.0,"(37.5, 52.0]",Q3
36109,2020-03-06,102793,47,0,0,0,0,0.0,0.0,"(37.5, 52.0]",Q3
36109,2020-03-07,102793,47,0,0,0,0,0.0,0.0,"(37.5, 52.0]",Q3
36109,2020-03-08,102793,47,0,0,0,0,0.0,0.0,"(37.5, 52.0]",Q3
36109,2020-03-09,102793,47,0,0,1,1,0.0,0.0,"(37.5, 52.0]",Q3
36109,2020-03-10,102793,47,0,0,0,1,0.0,0.0,"(37.5, 52.0]",Q3
36109,2020-03-11,102793,47,0,0,2,3,0.0,0.0,"(37.5, 52.0]",Q3
36109,2020-03-12,102793,47,0,0,2,5,0.0,0.0,"(37.5, 52.0]",Q3
36109,2020-03-13,102793,47,1,1,5,10,0.14285714285714285,0.13897555558952734,"(37.5, 52.0]",Q3
36109,2020-03-14,102793,47,0,1,1,11,0.14285714285714285,0.13897555558952734,"(37.5, 52.0]",Q3
36109,2020-03-15,102793,47,0,1,4,15,0.14285714285714285,0.13897555558952734,"(37.5, 52.0]",Q3
36109,2020-03-16,102793,47,1,2,17,32,0.2857142857142857,0.2779511111790547,"(37.5, 52.0]",Q3
36109,2020-03-17,102793,47,1,3,11,43,0.42857142857142855,0.4169266667685821,"(37.5, 52.0]",Q3
36109,2020-03-18,102793,47,3,6,18,61,0.8571428571428571,0.8338533335371642,"(37.5, 52.0]",Q3
36109,2020-03-19,102793,47,1,7,7,68,1.0,0.9728288891266915,"(37.5, 52.0]",Q3
36109,2020-03-20,102793,47,4,11,96,164,1.4285714285714286,1.3897555558952737,"(37.5, 52.0]",Q3
36109,2020-03-21,102793,47,2,13,76,240,1.7142857142857142,1.6677066670743284,"(37.5, 52.0]",Q3
36109,2020-03-22,102793,47,2,15,115,355,2.0,1.945657778253383,"(37.5, 52.0]",Q3
36109,2020-03-23,102793,47,1,16,111,466,2.0,1.945657778253383,"(37.5, 52.0]",Q3
36109,2020-03-24,102793,47,0,16,2,468,1.8571428571428572,1.8066822226638557,"(37.5, 52.0]",Q3
36109,2020-03-25,102793,47,6,22,89,557,2.2857142857142856,2.2236088894324375,"(37.5, 52.0]",Q3
36109,2020-03-26,102793,47,4,26,109,666,2.7142857142857144,2.6405355562010198,"(37.5, 52.0]",Q3
36109,2020-03-27,102793,47,19,45,182,848,4.857142857142857,4.725168890043929,"(37.5, 52.0]",Q3
36109,2020-03-28,102793,47,7,52,128,976,5.571428571428571,5.420046667991567,"(37.5, 52.0]",Q3
36109,2020-03-29,102793,47,14,66,157,1133,7.285714285714286,7.087753335065894,"(37.5, 52.0]",Q3
36109,2020-03-30,102793,47,0,66,18,1151,7.142857142857143,6.9487777794763685,"(37.5, 52.0]",Q3
36109,2020-03-31,102793,47,2,68,15,1166,7.428571428571429,7.226728890655423,"(37.5, 52.0]",Q3
36109,2020-04-01,102793,47,6,74,126,1292,7.428571428571429,7.226728890655423,"(37.5, 52.0]",Q3
36109,2020-04-02,102793,47,10,84,160,1452,8.285714285714286,8.060582224192588,"(37.5, 52.0]",Q3
36109,2020-04-03,102793,47,1,85,81,1533,5.714285714285714,5.559022223581095,"(37.5, 52.0]",Q3
36109,2020-04-04,102793,47,3,88,52,1585,5.142857142857143,5.003120001222985,"(37.5, 52.0]",Q3
36109,2020-04-05,102793,47,6,94,94,1679,4.0,3.891315556506766,"(37.5, 52.0]",Q3
36109,2020-04-06,102793,47,3,97,23,1702,4.428571428571429,4.308242223275348,"(37.5, 52.0]",Q3
36109,2020-04-07,102793,47,2,99,85,1787,4.428571428571429,4.308242223275348,"(37.5, 52.0]",Q3
36109,2020-04-08,102793,47,6,105,299,2086,4.428571428571429,4.308242223275348,"(37.5, 52.0]",Q3
36109,2020-04-09,102793,47,0,105,24,2110,3.0,2.9184866673800745,"(37.5, 52.0]",Q3
36109,2020-04-10,102793,47,3,108,135,2245,3.2857142857142856,3.196437778559129,"(37.5, 52.0]",Q3
36109,2020-04-11,102793,47,1,109,77,2322,3.0,2.9184866673800745,"(37.5, 52.0]",Q3
36109,2020-04-12,102793,47,1,110,31,2353,2.2857142857142856,2.2236088894324375,"(37.5, 52.0]",Q3
36109,2020-04-13,102793,47,2,112,104,2457,2.142857142857143,2.0846333338429104,"(37.5, 52.0]",Q3
36109,2020-04-14,102793,47,3,115,44,2501,2.2857142857142856,2.2236088894324375,"(37.5, 52.0]",Q3
36109,2020-04-15,102793,47,1,116,73,2574,1.5714285714285714,1.528731111484801,"(37.5, 52.0]",Q3
36109,2020-04-16,102793,47,1,117,36,2610,1.7142857142857142,1.6677066670743284,"(37.5, 52.0]",Q3
36109,2020-04-17,102793,47,0,117,44,2654,1.2857142857142858,1.2507800003057463,"(37.5, 52.0]",Q3
36109,2020-04-18,102793,47,0,117,41,2695,1.1428571428571428,1.1118044447162188,"(37.5, 52.0]",Q3
36109,2020-04-19,102793,47,2,119,47,2742,1.2857142857142858,1.2507800003057463,"(37.5, 52.0]",Q3
36109,2020-04-20,102793,47,0,119,4,2746,1.0,0.9728288891266915,"(37.5, 52.0]",Q3
36109,2020-04-21,102793,47,0,119,12,2758,0.5714285714285714,0.5559022223581094,"(37.5, 52.0]",Q3
36109,2020-04-22,102793,47,0,119,95,2853,0.42857142857142855,0.4169266667685821,"(37.5, 52.0]",Q3
36109,2020-04-23,102793,47,2,121,108,2961,0.5714285714285714,0.5559022223581094,"(37.5, 52.0]",Q3
36109,2020-04-24,102793,47,5,126,308,3269,1.2857142857142858,1.2507800003057463,"(37.5, 52.0]",Q3
36109,2020-04-25,102793,47,0,126,44,3313,1.2857142857142858,1.2507800003057463,"(37.5, 52.0]",Q3
36109,2020-04-26,102793,47,0,126,47,3360,1.0,0.9728288891266915,"(37.5, 52.0]",Q3
36109,2020-04-27,102793,47,0,126,13,3373,1.0,0.9728288891266915,"(37.5, 52.0]",Q3
36109,2020-04-28,102793,47,1,127,119,3492,1.1428571428571428,1.1118044447162188,"(37.5, 52.0]",Q3
36109,2020-04-29,102793,47,1,128,19,3511,1.2857142857142858,1.2507800003057463,"(37.5, 52.0]",Q3
36109,2020-04-30,102793,47,0,128,61,3572,1.0,0.9728288891266915,"(37.5, 52.0]",Q3
36109,2020-05-01,102793,47,0,128,118,3690,0.2857142857142857,0.2779511111790547,"(37.5, 52.0]",Q3
36109,2020-05-02,102793,47,1,129,27,3717,0.42857142857142855,0.4169266667685821,"(37.5, 52.0]",Q3
36109,2020-05-03,102793,47,0,129,126,3843,0.42857142857142855,0.4169266667685821,"(37.5, 52.0]",Q3
36109,2020-05-04,102793,47,0,129,52,3895,0.42857142857142855,0.4169266667685821,"(37.5, 52.0]",Q3
36109,2020-05-05,102793,47,0,129,104,3999,0.2857142857142857,0.2779511111790547,"(37.5, 52.0]",Q3
36109,2020-05-06,102793,47,1,130,188,4187,0.2857142857142857,0.2779511111790547,"(37.5, 52.0]",Q3
36109,2020-05-07,102793,47,1,131,187,4374,0.42857142857142855,0.4169266667685821,"(37.5, 52.0]",Q3
36109,2020-05-08,102793,47,1,132,619,4993,0.5714285714285714,0.5559022223581094,"(37.5, 52.0]",Q3
36109,2020-05-09,102793,47,0,132,95,5088,0.42857142857142855,0.4169266667685821,"(37.5, 52.0]",Q3
36109,2020-05-10,102793,47,0,132,86,5174,0.42857142857142855,0.4169266667685821,"(37.5, 52.0]",Q3
36109,2020-05-11,102793,47,0,132,91,5265,0.42857142857142855,0.4169266667685821,"(37.5, 52.0]",Q3
36109,2020-05-12,102793,47,4,136,175,5440,1.0,0.9728288891266915,"(37.5, 52.0]",Q3
36109,2020-05-13,102793,47,0,136,103,5543,0.8571428571428571,0.8338533335371642,"(37.5, 52.0]",Q3
36109,2020-05-14,102793,47,0,136,112,5655,0.7142857142857143,0.6948777779476368,"(37.5, 52.0]",Q3
36109,2020-05-15,102793,47,2,138,331,5986,0.8571428571428571,0.8338533335371642,"(37.5, 52.0]",Q3
36109,2020-05-16,102793,47,1,139,421,6407,1.0,0.9728288891266915,"(37.5, 52.0]",Q3
36109,2020-05-17,102793,47,2,141,412,6819,1.2857142857142858,1.2507800003057463,"(37.5, 52.0]",Q3
36109,2020-05-18,102793,47,1,142,446,7265,1.4285714285714286,1.3897555558952737,"(37.5, 52.0]",Q3
36109,2020-05-19,102793,47,3,145,219,7484,1.2857142857142858,1.2507800003057463,"(37.5, 52.0]",Q3
36109,2020-05-20,102793,47,0,145,199,7683,1.2857142857142858,1.2507800003057463,"(37.5, 52.0]",Q3
36109,2020-05-21,102793,47,2,147,291,7974,1.5714285714285714,1.528731111484801,"(37.5, 52.0]",Q3
36109,2020-05-22,102793,47,2,149,410,8384,1.5714285714285714,1.528731111484801,"(37.5, 52.0]",Q3
36109,2020-05-23,102793,47,2,151,246,8630,1.7142857142857142,1.6677066670743284,"(37.5, 52.0]",Q3
36109,2020-05-24,102793,47,3,154,267,8897,1.8571428571428572,1.8066822226638557,"(37.5, 52.0]",Q3
36109,2020-05-25,102793,47,0,154,48,8945,1.7142857142857142,1.6677066670743284,"(37.5, 52.0]",Q3
36109,2020-05-26,102793,47,1,155,264,9209,1.4285714285714286,1.3897555558952737,"(37.5, 52.0]",Q3
36109,2020-05-27,102793,47,1,156,110,9319,1.5714285714285714,1.528731111484801,"(37.5, 52.0]",Q3
36109,2020-05-28,102793,47,1,157,425,9744,1.4285714285714286,1.3897555558952737,"(37.5, 52.0]",Q3
36109,2020-05-29,102793,47,4,161,264,10008,1.7142857142857142,1.6677066670743284,"(37.5, 52.0]",Q3
36109,2020-05-30,102793,47,3,164,389,10397,1.8571428571428572,1.8066822226638557,"(37.5, 52.0]",Q3
36109,2020-05-31,102793,47,0,164,149,10546,1.4285714285714286,1.3897555558952737,"(37.5, 52.0]",Q3
36109,2020-06-01,102793,47,0,164,168,10714,1.4285714285714286,1.3897555558952737,"(37.5, 52.0]",Q3
36109,2020-06-02,102793,47,1,165,203,10917,1.4285714285714286,1.3897555558952737,"(37.5, 52.0]",Q3
36109,2020-06-03,102793,47,0,165,206,11123,1.2857142857142858,1.2507800003057463,"(37.5, 52.0]",Q3
36109,2020-06-04,102793,47,2,167,171,11294,1.4285714285714286,1.3897555558952737,"(37.5, 52.0]",Q3
36109,2020-06-05,102793,47,4,171,1067,12361,1.4285714285714286,1.3897555558952737,"(37.5, 52.0]",Q3
36109,2020-06-06,102793,47,0,171,518,12879,1.0,0.9728288891266915,"(37.5, 52.0]",Q3
36109,2020-06-07,102793,47,0,171,148,13027,1.0,0.9728288891266915,"(37.5, 52.0]",Q3
36111,2020-03-02,178599,34,0,0,0,0,0.0,0.0,"(24.0, 37.5]",Q2
36111,2020-03-03,178599,34,0,0,0,0,0.0,0.0,"(24.0, 37.5]",Q2
36111,2020-03-04,178599,34,0,0,0,0,0.0,0.0,"(24.0, 37.5]",Q2
36111,2020-03-05,178599,34,0,0,1,1,0.0,0.0,"(24.0, 37.5]",Q2
36111,2020-03-06,178599,34,0,0,0,1,0.0,0.0,"(24.0, 37.5]",Q2
36111,2020-03-07,178599,34,0,0,0,1,0.0,0.0,"(24.0, 37.5]",Q2
36111,2020-03-08,178599,34,1,1,1,2,0.14285714285714285,0.07998764990685438,"(24.0, 37.5]",Q2
36111,2020-03-09,178599,34,0,1,0,2,0.14285714285714285,0.07998764990685438,"(24.0, 37.5]",Q2
36111,2020-03-10,178599,34,0,1,2,4,0.14285714285714285,0.07998764990685438,"(24.0, 37.5]",Q2
36111,2020-03-11,178599,34,1,2,1,5,0.2857142857142857,0.15997529981370875,"(24.0, 37.5]",Q2
36111,2020-03-12,178599,34,3,5,6,11,0.7142857142857143,0.3999382495342719,"(24.0, 37.5]",Q2
36111,2020-03-13,178599,34,0,5,3,14,0.7142857142857143,0.3999382495342719,"(24.0, 37.5]",Q2
36111,2020-03-14,178599,34,0,5,30,44,0.7142857142857143,0.3999382495342719,"(24.0, 37.5]",Q2
36111,2020-03-15,178599,34,2,7,16,60,0.8571428571428571,0.47992589944112624,"(24.0, 37.5]",Q2
36111,2020-03-16,178599,34,1,8,12,72,1.0,0.5599135493479808,"(24.0, 37.5]",Q2
36111,2020-03-17,178599,34,1,9,15,87,1.1428571428571428,0.639901199254835,"(24.0, 37.5]",Q2
36111,2020-03-18,178599,34,1,10,41,128,1.1428571428571428,0.639901199254835,"(24.0, 37.5]",Q2
36111,2020-03-19,178599,34,2,12,62,190,1.0,0.5599135493479808,"(24.0, 37.5]",Q2
36111,2020-03-20,178599,34,6,18,70,260,1.8571428571428572,1.039839448789107,"(24.0, 37.5]",Q2
36111,2020-03-21,178599,34,8,26,145,405,3.0,1.679740648043942,"(24.0, 37.5]",Q2
36111,2020-03-22,178599,34,9,35,54,459,4.0,2.239654197391923,"(24.0, 37.5]",Q2
36111,2020-03-23,178599,34,12,47,117,576,5.571428571428571,3.119518346367321,"(24.0, 37.5]",Q2
36111,2020-03-24,178599,34,18,65,81,657,8.0,4.479308394783846,"(24.0, 37.5]",Q2
36111,2020-03-25,178599,34,13,78,71,728,9.714285714285714,5.439160193666098,"(24.0, 37.5]",Q2
36111,2020-03-26,178599,34,21,99,83,811,12.428571428571429,6.958925541896331,"(24.0, 37.5]",Q2
36111,2020-03-27,178599,34,29,128,124,935,15.714285714285714,8.798641489753981,"(24.0, 37.5]",Q2
36111,2020-03-28,178599,34,18,146,82,1017,17.142857142857142,9.598517988822525,"(24.0, 37.5]",Q2
36111,2020-03-29,178599,34,44,190,194,1211,22.142857142857142,12.398085735562429,"(24.0, 37.5]",Q2
36111,2020-03-30,178599,34,21,211,123,1334,23.428571428571427,13.117974584724118,"(24.0, 37.5]",Q2
36111,2020-03-31,178599,34,10,221,51,1385,22.285714285714285,12.478073385469283,"(24.0, 37.5]",Q2
36111,2020-04-01,178599,34,19,240,118,1503,23.142857142857142,12.957999284910409,"(24.0, 37.5]",Q2
36111,2020-04-02,178599,34,23,263,125,1628,23.428571428571427,13.117974584724118,"(24.0, 37.5]",Q2
36111,2020-04-03,178599,34,27,290,141,1769,23.142857142857142,12.957999284910409,"(24.0, 37.5]",Q2
36111,2020-04-04,178599,34,42,332,188,1957,26.571428571428573,14.877702882674916,"(24.0, 37.5]",Q2
36111,2020-04-05,178599,34,40,372,182,2139,26.0,14.557752283047497,"(24.0, 37.5]",Q2
36111,2020-04-06,178599,34,26,398,117,2256,26.714285714285715,14.95769053258177,"(24.0, 37.5]",Q2
36111,2020-04-07,178599,34,24,422,108,2364,28.714285714285715,16.07751763127773,"(24.0, 37.5]",Q2
36111,2020-04-08,178599,34,38,460,227,2591,31.428571428571427,17.597282979507963,"(24.0, 37.5]",Q2
36111,2020-04-09,178599,34,70,530,436,3027,38.142857142857146,21.35670252513012,"(24.0, 37.5]",Q2
36111,2020-04-10,178599,34,59,589,358,3385,42.714285714285715,23.91630732214946,"(24.0, 37.5]",Q2
36111,2020-04-11,178599,34,23,612,239,3624,40.0,22.396541973919227,"(24.0, 37.5]",Q2
36111,2020-04-12,178599,34,18,630,242,3866,36.857142857142854,20.63681367596843,"(24.0, 37.5]",Q2
36111,2020-04-13,178599,34,60,690,424,4290,41.714285714285715,23.356393772801482,"(24.0, 37.5]",Q2
36111,2020-04-14,178599,34,43,733,259,4549,44.42857142857143,24.876159121031716,"(24.0, 37.5]",Q2
36111,2020-04-15,178599,34,28,761,189,4738,43.0,24.07628262196317,"(24.0, 37.5]",Q2
36111,2020-04-16,178599,34,27,788,142,4880,36.857142857142854,20.63681367596843,"(24.0, 37.5]",Q2
36111,2020-04-17,178599,34,32,820,239,5119,33.0,18.47714712848336,"(24.0, 37.5]",Q2
36111,2020-04-18,178599,34,34,854,170,5289,34.57142857142857,19.357011277458756,"(24.0, 37.5]",Q2
36111,2020-04-19,178599,34,23,877,167,5456,35.285714285714285,19.756949526993033,"(24.0, 37.5]",Q2
36111,2020-04-20,178599,34,16,893,85,5541,29.0,16.237492931091438,"(24.0, 37.5]",Q2
36111,2020-04-21,178599,34,20,913,110,5651,25.714285714285715,14.39777698323379,"(24.0, 37.5]",Q2
36111,2020-04-22,178599,34,29,942,152,5803,25.857142857142858,14.477764633140643,"(24.0, 37.5]",Q2
36111,2020-04-23,178599,34,34,976,208,6011,26.857142857142858,15.037678182488625,"(24.0, 37.5]",Q2
36111,2020-04-24,178599,34,190,1166,928,6939,49.42857142857143,27.67572686777162,"(24.0, 37.5]",Q2
36111,2020-04-25,178599,34,24,1190,207,7146,48.0,26.875850368703073,"(24.0, 37.5]",Q2
36111,2020-04-26,178599,34,29,1219,198,7344,48.857142857142854,27.3557762681442,"(24.0, 37.5]",Q2
36111,2020-04-27,178599,34,11,1230,94,7438,48.142857142857146,26.955838018609928,"(24.0, 37.5]",Q2
36111,2020-04-28,178599,34,22,1252,335,7773,48.42857142857143,27.115813318423633,"(24.0, 37.5]",Q2
36111,2020-04-29,178599,34,27,1279,309,8082,48.142857142857146,26.955838018609928,"(24.0, 37.5]",Q2
36111,2020-04-30,178599,34,19,1298,336,8418,46.0,25.756023270007113,"(24.0, 37.5]",Q2
36111,2020-05-01,178599,34,29,1327,362,8780,23.0,12.878011635003556,"(24.0, 37.5]",Q2
36111,2020-05-02,178599,34,14,1341,256,9036,21.571428571428573,12.078135135935012,"(24.0, 37.5]",Q2
36111,2020-05-03,178599,34,13,1354,198,9234,19.285714285714285,10.79833273742534,"(24.0, 37.5]",Q2
36111,2020-05-04,178599,34,3,1357,104,9338,18.142857142857142,10.158431538170507,"(24.0, 37.5]",Q2
36111,2020-05-05,178599,34,26,1383,272,9610,18.714285714285715,10.478382137797924,"(24.0, 37.5]",Q2
36111,2020-05-06,178599,34,33,1416,298,9908,19.571428571428573,10.958308037239052,"(24.0, 37.5]",Q2
36111,2020-05-07,178599,34,13,1429,276,10184,18.714285714285715,10.478382137797924,"(24.0, 37.5]",Q2
36111,2020-05-08,178599,34,11,1440,195,10379,16.142857142857142,9.038604439474545,"(24.0, 37.5]",Q2
36111,2020-05-09,178599,34,10,1450,210,10589,15.571428571428571,8.718653839847127,"(24.0, 37.5]",Q2
36111,2020-05-10,178599,34,4,1454,135,10724,14.285714285714286,7.998764990685438,"(24.0, 37.5]",Q2
36111,2020-05-11,178599,34,11,1465,96,10820,15.428571428571429,8.638666189940272,"(24.0, 37.5]",Q2
36111,2020-05-12,178599,34,16,1481,314,11134,14.0,7.838789690871729,"(24.0, 37.5]",Q2
36111,2020-05-13,178599,34,14,1495,536,11670,11.285714285714286,6.319024342641497,"(24.0, 37.5]",Q2
36111,2020-05-14,178599,34,16,1511,431,12101,11.714285714285714,6.558987292362059,"(24.0, 37.5]",Q2
36111,2020-05-15,178599,34,26,1537,398,12499,13.857142857142858,7.758802040964874,"(24.0, 37.5]",Q2
36111,2020-05-16,178599,34,15,1552,345,12844,14.571428571428571,8.158740290499146,"(24.0, 37.5]",Q2
36111,2020-05-17,178599,34,5,1557,227,13071,14.714285714285714,8.238727940406001,"(24.0, 37.5]",Q2
36111,2020-05-18,178599,34,8,1565,177,13248,14.285714285714286,7.998764990685438,"(24.0, 37.5]",Q2
36111,2020-05-19,178599,34,6,1571,284,13532,12.857142857142858,7.198888491616895,"(24.0, 37.5]",Q2
36111,2020-05-20,178599,34,13,1584,799,14331,12.714285714285714,7.118900841710039,"(24.0, 37.5]",Q2
36111,2020-05-21,178599,34,11,1595,552,14883,12.0,6.718962592175768,"(24.0, 37.5]",Q2
36111,2020-05-22,178599,34,11,1606,418,15301,9.857142857142858,5.519147843572952,"(24.0, 37.5]",Q2
36111,2020-05-23,178599,34,11,1617,470,15771,9.285714285714286,5.199197243945536,"(24.0, 37.5]",Q2
36111,2020-05-24,178599,34,15,1632,590,16361,10.714285714285714,5.999073743014078,"(24.0, 37.5]",Q2
36111,2020-05-25,178599,34,6,1638,162,16523,10.428571428571429,5.8390984432003705,"(24.0, 37.5]",Q2
36111,2020-05-26,178599,34,7,1645,355,16878,10.571428571428571,5.919086093107224,"(24.0, 37.5]",Q2
36111,2020-05-27,178599,34,13,1658,556,17434,10.571428571428571,5.919086093107224,"(24.0, 37.5]",Q2
36111,2020-05-28,178599,34,5,1663,683,18117,9.714285714285714,5.439160193666098,"(24.0, 37.5]",Q2
36111,2020-05-29,178599,34,15,1678,746,18863,10.285714285714286,5.759110793293516,"(24.0, 37.5]",Q2
36111,2020-05-30,178599,34,7,1685,529,19392,9.714285714285714,5.439160193666098,"(24.0, 37.5]",Q2
36111,2020-05-31,178599,34,6,1691,538,19930,8.428571428571429,4.719271344504409,"(24.0, 37.5]",Q2
36111,2020-06-01,178599,34,5,1696,327,20257,8.285714285714286,4.639283694597554,"(24.0, 37.5]",Q2
36111,2020-06-02,178599,34,5,1701,504,20761,8.0,4.479308394783846,"(24.0, 37.5]",Q2
36111,2020-06-03,178599,34,3,1704,617,21378,6.571428571428571,3.6794318957153016,"(24.0, 37.5]",Q2
36111,2020-06-04,178599,34,7,1711,1121,22499,6.857142857142857,3.83940719552901,"(24.0, 37.5]",Q2
36111,2020-06-05,178599,34,3,1714,776,23275,5.142857142857143,2.879555396646758,"(24.0, 37.5]",Q2
36111,2020-06-06,178599,34,4,1718,600,23875,4.714285714285714,2.6395924469261947,"(24.0, 37.5]",Q2
36111,2020-06-07,178599,34,3,1721,644,24519,4.285714285714286,2.3996294972056313,"(24.0, 37.5]",Q2
36113,2020-03-02,64265,22,0,0,0,0,0.0,0.0,"(3.999, 24.0]",Q1
36113,2020-03-03,64265,22,0,0,0,0,0.0,0.0,"(3.999, 24.0]",Q1
36113,2020-03-04,64265,22,0,0,0,0,0.0,0.0,"(3.999, 24.0]",Q1
36113,2020-03-05,64265,22,0,0,0,0,0.0,0.0,"(3.999, 24.0]",Q1
36113,2020-03-06,64265,22,0,0,0,0,0.0,0.0,"(3.999, 24.0]",Q1
36113,2020-03-07,64265,22,0,0,1,1,0.0,0.0,"(3.999, 24.0]",Q1
36113,2020-03-08,64265,22,0,0,0,1,0.0,0.0,"(3.999, 24.0]",Q1
36113,2020-03-09,64265,22,0,0,0,1,0.0,0.0,"(3.999, 24.0]",Q1
36113,2020-03-10,64265,22,0,0,2,3,0.0,0.0,"(3.999, 24.0]",Q1
36113,2020-03-11,64265,22,0,0,1,4,0.0,0.0,"(3.999, 24.0]",Q1
36113,2020-03-12,64265,22,0,0,0,4,0.0,0.0,"(3.999, 24.0]",Q1
36113,2020-03-13,64265,22,0,0,2,6,0.0,0.0,"(3.999, 24.0]",Q1
36113,2020-03-14,64265,22,0,0,13,19,0.0,0.0,"(3.999, 24.0]",Q1
36113,2020-03-15,64265,22,0,0,12,31,0.0,0.0,"(3.999, 24.0]",Q1
36113,2020-03-16,64265,22,0,0,14,45,0.0,0.0,"(3.999, 24.0]",Q1
36113,2020-03-17,64265,22,1,1,16,61,0.14285714285714285,0.22229385024063306,"(3.999, 24.0]",Q1
36113,2020-03-18,64265,22,0,1,8,69,0.14285714285714285,0.22229385024063306,"(3.999, 24.0]",Q1
36113,2020-03-19,64265,22,0,1,17,86,0.14285714285714285,0.22229385024063306,"(3.999, 24.0]",Q1
36113,2020-03-20,64265,22,0,1,31,117,0.14285714285714285,0.22229385024063306,"(3.999, 24.0]",Q1
36113,2020-03-21,64265,22,0,1,28,145,0.14285714285714285,0.22229385024063306,"(3.999, 24.0]",Q1
36113,2020-03-22,64265,22,1,2,81,226,0.2857142857142857,0.4445877004812661,"(3.999, 24.0]",Q1
36113,2020-03-23,64265,22,0,2,8,234,0.2857142857142857,0.4445877004812661,"(3.999, 24.0]",Q1
36113,2020-03-24,64265,22,0,2,52,286,0.14285714285714285,0.22229385024063306,"(3.999, 24.0]",Q1
36113,2020-03-25,64265,22,0,2,16,302,0.14285714285714285,0.22229385024063306,"(3.999, 24.0]",Q1
36113,2020-03-26,64265,22,6,8,54,356,1.0,1.5560569516844316,"(3.999, 24.0]",Q1
36113,2020-03-27,64265,22,5,13,59,415,1.7142857142857142,2.667526202887597,"(3.999, 24.0]",Q1
36113,2020-03-28,64265,22,5,18,38,453,2.4285714285714284,3.778995454090762,"(3.999, 24.0]",Q1
36113,2020-03-29,64265,22,0,18,3,456,2.2857142857142856,3.556701603850129,"(3.999, 24.0]",Q1
36113,2020-03-30,64265,22,0,18,6,462,2.2857142857142856,3.556701603850129,"(3.999, 24.0]",Q1
36113,2020-03-31,64265,22,0,18,7,469,2.2857142857142856,3.556701603850129,"(3.999, 24.0]",Q1
36113,2020-04-01,64265,22,0,18,9,478,2.2857142857142856,3.556701603850129,"(3.999, 24.0]",Q1
36113,2020-04-02,64265,22,1,19,11,489,1.5714285714285714,2.445232352646964,"(3.999, 24.0]",Q1
36113,2020-04-03,64265,22,1,20,7,496,1.0,1.5560569516844316,"(3.999, 24.0]",Q1
36113,2020-04-04,64265,22,5,25,13,509,1.0,1.5560569516844316,"(3.999, 24.0]",Q1
36113,2020-04-05,64265,22,1,26,12,521,1.1428571428571428,1.7783508019250645,"(3.999, 24.0]",Q1
36113,2020-04-06,64265,22,5,31,15,536,1.8571428571428572,2.8898200531282305,"(3.999, 24.0]",Q1
36113,2020-04-07,64265,22,2,33,14,550,2.142857142857143,3.3344077536094963,"(3.999, 24.0]",Q1
36113,2020-04-08,64265,22,7,40,31,581,3.142857142857143,4.890464705293928,"(3.999, 24.0]",Q1
36113,2020-04-09,64265,22,3,43,21,602,3.4285714285714284,5.335052405775194,"(3.999, 24.0]",Q1
36113,2020-04-10,64265,22,1,44,17,619,3.4285714285714284,5.335052405775194,"(3.999, 24.0]",Q1
36113,2020-04-11,64265,22,2,46,20,639,3.0,4.668170855053296,"(3.999, 24.0]",Q1
36113,2020-04-12,64265,22,2,48,18,657,3.142857142857143,4.890464705293928,"(3.999, 24.0]",Q1
36113,2020-04-13,64265,22,29,77,67,724,6.571428571428571,10.225517111069122,"(3.999, 24.0]",Q1
36113,2020-04-14,64265,22,0,77,7,731,6.285714285714286,9.780929410587856,"(3.999, 24.0]",Q1
36113,2020-04-15,64265,22,4,81,35,766,5.857142857142857,9.114047859865956,"(3.999, 24.0]",Q1
36113,2020-04-16,64265,22,10,91,41,807,6.857142857142857,10.670104811550388,"(3.999, 24.0]",Q1
36113,2020-04-17,64265,22,3,94,38,845,7.142857142857143,11.114692512031656,"(3.999, 24.0]",Q1
36113,2020-04-18,64265,22,2,96,27,872,7.142857142857143,11.114692512031656,"(3.999, 24.0]",Q1
36113,2020-04-19,64265,22,5,101,20,892,7.571428571428571,11.781574062753553,"(3.999, 24.0]",Q1
36113,2020-04-20,64265,22,1,102,13,905,3.5714285714285716,5.557346256015828,"(3.999, 24.0]",Q1
36113,2020-04-21,64265,22,6,108,33,938,4.428571428571429,6.8911093574596265,"(3.999, 24.0]",Q1
36113,2020-04-22,64265,22,11,119,40,978,5.428571428571429,8.447166309144057,"(3.999, 24.0]",Q1
36113,2020-04-23,64265,22,3,122,38,1016,4.428571428571429,6.8911093574596265,"(3.999, 24.0]",Q1
36113,2020-04-24,64265,22,10,132,94,1110,5.428571428571429,8.447166309144057,"(3.999, 24.0]",Q1
36113,2020-04-25,64265,22,3,135,61,1171,5.571428571428571,8.66946015938469,"(3.999, 24.0]",Q1
36113,2020-04-26,64265,22,12,147,60,1231,6.571428571428571,10.225517111069122,"(3.999, 24.0]",Q1
36113,2020-04-27,64265,22,3,150,25,1256,6.857142857142857,10.670104811550388,"(3.999, 24.0]",Q1
36113,2020-04-28,64265,22,2,152,12,1268,6.285714285714286,9.780929410587856,"(3.999, 24.0]",Q1
36113,2020-04-29,64265,22,24,176,105,1373,8.142857142857142,12.670749463716087,"(3.999, 24.0]",Q1
36113,2020-04-30,64265,22,6,182,94,1467,8.571428571428571,13.337631014437985,"(3.999, 24.0]",Q1
36113,2020-05-01,64265,22,3,185,66,1533,7.571428571428571,11.781574062753553,"(3.999, 24.0]",Q1
36113,2020-05-02,64265,22,3,188,43,1576,7.571428571428571,11.781574062753553,"(3.999, 24.0]",Q1
36113,2020-05-03,64265,22,4,192,53,1629,6.428571428571429,10.00322326082849,"(3.999, 24.0]",Q1
36113,2020-05-04,64265,22,0,192,34,1663,6.0,9.336341710106591,"(3.999, 24.0]",Q1
36113,2020-05-05,64265,22,1,193,22,1685,5.857142857142857,9.114047859865956,"(3.999, 24.0]",Q1
36113,2020-05-06,64265,22,0,193,44,1729,2.4285714285714284,3.778995454090762,"(3.999, 24.0]",Q1
36113,2020-05-07,64265,22,6,199,72,1801,2.4285714285714284,3.778995454090762,"(3.999, 24.0]",Q1
36113,2020-05-08,64265,22,3,202,97,1898,2.4285714285714284,3.778995454090762,"(3.999, 24.0]",Q1
36113,2020-05-09,64265,22,5,207,149,2047,2.7142857142857144,4.223583154572029,"(3.999, 24.0]",Q1
36113,2020-05-10,64265,22,10,217,90,2137,3.5714285714285716,5.557346256015828,"(3.999, 24.0]",Q1
36113,2020-05-11,64265,22,4,221,40,2177,4.142857142857143,6.44652165697836,"(3.999, 24.0]",Q1
36113,2020-05-12,64265,22,2,223,127,2304,4.285714285714286,6.6688155072189925,"(3.999, 24.0]",Q1
36113,2020-05-13,64265,22,4,227,192,2496,4.857142857142857,7.557990908181524,"(3.999, 24.0]",Q1
36113,2020-05-14,64265,22,1,228,137,2633,4.142857142857143,6.44652165697836,"(3.999, 24.0]",Q1
36113,2020-05-15,64265,22,0,228,116,2749,3.7142857142857144,5.779640106256461,"(3.999, 24.0]",Q1
36113,2020-05-16,64265,22,4,232,205,2954,3.5714285714285716,5.557346256015828,"(3.999, 24.0]",Q1
36113,2020-05-17,64265,22,2,234,130,3084,2.4285714285714284,3.778995454090762,"(3.999, 24.0]",Q1
36113,2020-05-18,64265,22,1,235,52,3136,2.0,3.112113903368863,"(3.999, 24.0]",Q1
36113,2020-05-19,64265,22,0,235,102,3238,1.7142857142857142,2.667526202887597,"(3.999, 24.0]",Q1
36113,2020-05-20,64265,22,6,241,213,3451,2.0,3.112113903368863,"(3.999, 24.0]",Q1
36113,2020-05-21,64265,22,5,246,234,3685,2.5714285714285716,4.0012893043313955,"(3.999, 24.0]",Q1
36113,2020-05-22,64265,22,3,249,114,3799,3.0,4.668170855053296,"(3.999, 24.0]",Q1
36113,2020-05-23,64265,22,1,250,159,3958,2.5714285714285716,4.0012893043313955,"(3.999, 24.0]",Q1
36113,2020-05-24,64265,22,1,251,65,4023,2.4285714285714284,3.778995454090762,"(3.999, 24.0]",Q1
36113,2020-05-25,64265,22,0,251,56,4079,2.2857142857142856,3.556701603850129,"(3.999, 24.0]",Q1
36113,2020-05-26,64265,22,1,252,111,4190,2.4285714285714284,3.778995454090762,"(3.999, 24.0]",Q1
36113,2020-05-27,64265,22,1,253,116,4306,1.7142857142857142,2.667526202887597,"(3.999, 24.0]",Q1
36113,2020-05-28,64265,22,1,254,205,4511,1.1428571428571428,1.7783508019250645,"(3.999, 24.0]",Q1
36113,2020-05-29,64265,22,1,255,235,4746,0.8571428571428571,1.3337631014437985,"(3.999, 24.0]",Q1
36113,2020-05-30,64265,22,0,255,255,5001,0.7142857142857143,1.1114692512031654,"(3.999, 24.0]",Q1
36113,2020-05-31,64265,22,0,255,112,5113,0.5714285714285714,0.8891754009625322,"(3.999, 24.0]",Q1
36113,2020-06-01,64265,22,0,255,139,5252,0.5714285714285714,0.8891754009625322,"(3.999, 24.0]",Q1
36113,2020-06-02,64265,22,1,256,156,5408,0.5714285714285714,0.8891754009625322,"(3.999, 24.0]",Q1
36113,2020-06-03,64265,22,0,256,344,5752,0.42857142857142855,0.6668815507218993,"(3.999, 24.0]",Q1
36113,2020-06-04,64265,22,0,256,235,5987,0.2857142857142857,0.4445877004812661,"(3.999, 24.0]",Q1
36113,2020-06-05,64265,22,1,257,137,6124,0.2857142857142857,0.4445877004812661,"(3.999, 24.0]",Q1
36113,2020-06-06,64265,22,0,257,256,6380,0.2857142857142857,0.4445877004812661,"(3.999, 24.0]",Q1
36113,2020-06-07,64265,22,0,257,204,6584,0.2857142857142857,0.4445877004812661,"(3.999, 24.0]",Q1
36115,2020-03-02,61197,36,0,0,0,0,0.0,0.0,"(24.0, 37.5]",Q2
36115,2020-03-03,61197,36,0,0,0,0,0.0,0.0,"(24.0, 37.5]",Q2
36115,2020-03-04,61197,36,0,0,0,0,0.0,0.0,"(24.0, 37.5]",Q2
36115,2020-03-05,61197,36,0,0,0,0,0.0,0.0,"(24.0, 37.5]",Q2
36115,2020-03-06,61197,36,0,0,0,0,0.0,0.0,"(24.0, 37.5]",Q2
36115,2020-03-07,61197,36,0,0,0,0,0.0,0.0,"(24.0, 37.5]",Q2
36115,2020-03-08,61197,36,0,0,2,2,0.0,0.0,"(24.0, 37.5]",Q2
36115,2020-03-09,61197,36,0,0,0,2,0.0,0.0,"(24.0, 37.5]",Q2
36115,2020-03-10,61197,36,0,0,1,3,0.0,0.0,"(24.0, 37.5]",Q2
36115,2020-03-11,61197,36,0,0,4,7,0.0,0.0,"(24.0, 37.5]",Q2
36115,2020-03-12,61197,36,0,0,0,7,0.0,0.0,"(24.0, 37.5]",Q2
36115,2020-03-13,61197,36,0,0,1,8,0.0,0.0,"(24.0, 37.5]",Q2
36115,2020-03-14,61197,36,0,0,1,9,0.0,0.0,"(24.0, 37.5]",Q2
36115,2020-03-15,61197,36,0,0,5,14,0.0,0.0,"(24.0, 37.5]",Q2
36115,2020-03-16,61197,36,0,0,4,18,0.0,0.0,"(24.0, 37.5]",Q2
36115,2020-03-17,61197,36,1,1,9,27,0.14285714285714285,0.2334381470613639,"(24.0, 37.5]",Q2
36115,2020-03-18,61197,36,0,1,5,32,0.14285714285714285,0.2334381470613639,"(24.0, 37.5]",Q2
36115,2020-03-19,61197,36,0,1,8,40,0.14285714285714285,0.2334381470613639,"(24.0, 37.5]",Q2
36115,2020-03-20,61197,36,0,1,10,50,0.14285714285714285,0.2334381470613639,"(24.0, 37.5]",Q2
36115,2020-03-21,61197,36,0,1,18,68,0.14285714285714285,0.2334381470613639,"(24.0, 37.5]",Q2
36115,2020-03-22,61197,36,2,3,52,120,0.42857142857142855,0.7003144411840916,"(24.0, 37.5]",Q2
36115,2020-03-23,61197,36,0,3,7,127,0.42857142857142855,0.7003144411840916,"(24.0, 37.5]",Q2
36115,2020-03-24,61197,36,1,4,25,152,0.42857142857142855,0.7003144411840916,"(24.0, 37.5]",Q2
36115,2020-03-25,61197,36,0,4,18,170,0.42857142857142855,0.7003144411840916,"(24.0, 37.5]",Q2
36115,2020-03-26,61197,36,2,6,19,189,0.7142857142857143,1.1671907353068194,"(24.0, 37.5]",Q2
36115,2020-03-27,61197,36,0,6,40,229,0.7142857142857143,1.1671907353068194,"(24.0, 37.5]",Q2
36115,2020-03-28,61197,36,1,7,20,249,0.8571428571428571,1.4006288823681832,"(24.0, 37.5]",Q2
36115,2020-03-29,61197,36,0,7,10,259,0.5714285714285714,0.9337525882454556,"(24.0, 37.5]",Q2
36115,2020-03-30,61197,36,3,10,7,266,1.0,1.634067029429547,"(24.0, 37.5]",Q2
36115,2020-03-31,61197,36,0,10,5,271,0.8571428571428571,1.4006288823681832,"(24.0, 37.5]",Q2
36115,2020-04-01,61197,36,2,12,9,280,1.1428571428571428,1.8675051764909112,"(24.0, 37.5]",Q2
36115,2020-04-02,61197,36,3,15,13,293,1.2857142857142858,2.100943323552275,"(24.0, 37.5]",Q2
36115,2020-04-03,61197,36,1,16,9,302,1.4285714285714286,2.3343814706136388,"(24.0, 37.5]",Q2
36115,2020-04-04,61197,36,2,18,15,317,1.5714285714285714,2.5678196176750028,"(24.0, 37.5]",Q2
36115,2020-04-05,61197,36,1,19,2,319,1.7142857142857142,2.8012577647363663,"(24.0, 37.5]",Q2
36115,2020-04-06,61197,36,0,19,13,332,1.2857142857142858,2.100943323552275,"(24.0, 37.5]",Q2
36115,2020-04-07,61197,36,1,20,27,359,1.4285714285714286,2.3343814706136388,"(24.0, 37.5]",Q2
36115,2020-04-08,61197,36,5,25,24,383,1.8571428571428572,3.034695911797731,"(24.0, 37.5]",Q2
36115,2020-04-09,61197,36,1,26,14,397,1.5714285714285714,2.5678196176750028,"(24.0, 37.5]",Q2
36115,2020-04-10,61197,36,5,31,16,413,2.142857142857143,3.501572205920458,"(24.0, 37.5]",Q2
36115,2020-04-11,61197,36,3,34,18,431,2.2857142857142856,3.7350103529818224,"(24.0, 37.5]",Q2
36115,2020-04-12,61197,36,3,37,15,446,2.5714285714285716,4.20188664710455,"(24.0, 37.5]",Q2
36115,2020-04-13,61197,36,3,40,36,482,3.0,4.902201088288641,"(24.0, 37.5]",Q2
36115,2020-04-14,61197,36,2,42,8,490,3.142857142857143,5.1356392353500055,"(24.0, 37.5]",Q2
36115,2020-04-15,61197,36,4,46,24,514,3.0,4.902201088288641,"(24.0, 37.5]",Q2
36115,2020-04-16,61197,36,2,48,19,533,3.142857142857143,5.1356392353500055,"(24.0, 37.5]",Q2
36115,2020-04-17,61197,36,4,52,25,558,3.0,4.902201088288641,"(24.0, 37.5]",Q2
36115,2020-04-18,61197,36,11,63,35,593,4.142857142857143,6.769706264779553,"(24.0, 37.5]",Q2
36115,2020-04-19,61197,36,2,65,9,602,4.0,6.536268117718188,"(24.0, 37.5]",Q2
36115,2020-04-20,61197,36,3,68,12,614,4.0,6.536268117718188,"(24.0, 37.5]",Q2
36115,2020-04-21,61197,36,5,73,17,631,4.428571428571429,7.236582558902281,"(24.0, 37.5]",Q2
36115,2020-04-22,61197,36,7,80,36,667,4.857142857142857,7.936897000086372,"(24.0, 37.5]",Q2
36115,2020-04-23,61197,36,3,83,26,693,5.0,8.170335147147735,"(24.0, 37.5]",Q2
36115,2020-04-24,61197,36,30,113,134,827,8.714285714285714,14.239726970743195,"(24.0, 37.5]",Q2
36115,2020-04-25,61197,36,14,127,51,878,9.142857142857142,14.94004141192729,"(24.0, 37.5]",Q2
36115,2020-04-26,61197,36,3,130,37,915,9.285714285714286,15.173479558988653,"(24.0, 37.5]",Q2
36115,2020-04-27,61197,36,1,131,13,928,9.0,14.706603264865926,"(24.0, 37.5]",Q2
36115,2020-04-28,61197,36,3,134,19,947,8.714285714285714,14.239726970743195,"(24.0, 37.5]",Q2
36115,2020-04-29,61197,36,14,148,58,1005,9.714285714285714,15.873794000172744,"(24.0, 37.5]",Q2
36115,2020-04-30,61197,36,22,170,88,1093,12.428571428571429,20.30911879433866,"(24.0, 37.5]",Q2
36115,2020-05-01,61197,36,14,184,63,1156,10.142857142857142,16.574108441356834,"(24.0, 37.5]",Q2
36115,2020-05-02,61197,36,2,186,63,1219,8.428571428571429,13.77285067662047,"(24.0, 37.5]",Q2
36115,2020-05-03,61197,36,2,188,31,1250,8.285714285714286,13.539412529559106,"(24.0, 37.5]",Q2
36115,2020-05-04,61197,36,0,188,22,1272,8.142857142857142,13.305974382497741,"(24.0, 37.5]",Q2
36115,2020-05-05,61197,36,1,189,25,1297,7.857142857142857,12.839098088375012,"(24.0, 37.5]",Q2
36115,2020-05-06,61197,36,1,190,20,1317,6.0,9.804402176577282,"(24.0, 37.5]",Q2
36115,2020-05-07,61197,36,11,201,106,1423,4.428571428571429,7.236582558902281,"(24.0, 37.5]",Q2
36115,2020-05-08,61197,36,3,204,86,1509,2.857142857142857,4.6687629412272775,"(24.0, 37.5]",Q2
36115,2020-05-09,61197,36,2,206,60,1569,2.857142857142857,4.6687629412272775,"(24.0, 37.5]",Q2
36115,2020-05-10,61197,36,4,210,39,1608,3.142857142857143,5.1356392353500055,"(24.0, 37.5]",Q2
36115,2020-05-11,61197,36,0,210,24,1632,3.142857142857143,5.1356392353500055,"(24.0, 37.5]",Q2
36115,2020-05-12,61197,36,4,214,66,1698,3.5714285714285716,5.835953676534098,"(24.0, 37.5]",Q2
36115,2020-05-13,61197,36,1,215,77,1775,3.5714285714285716,5.835953676534098,"(24.0, 37.5]",Q2
36115,2020-05-14,61197,36,2,217,65,1840,2.2857142857142856,3.7350103529818224,"(24.0, 37.5]",Q2
36115,2020-05-15,61197,36,1,218,75,1915,2.0,3.268134058859094,"(24.0, 37.5]",Q2
36115,2020-05-16,61197,36,1,219,70,1985,1.8571428571428572,3.034695911797731,"(24.0, 37.5]",Q2
36115,2020-05-17,61197,36,0,219,47,2032,1.2857142857142858,2.100943323552275,"(24.0, 37.5]",Q2
36115,2020-05-18,61197,36,1,220,41,2073,1.4285714285714286,2.3343814706136388,"(24.0, 37.5]",Q2
36115,2020-05-19,61197,36,1,221,66,2139,1.0,1.634067029429547,"(24.0, 37.5]",Q2
36115,2020-05-20,61197,36,1,222,87,2226,1.0,1.634067029429547,"(24.0, 37.5]",Q2
36115,2020-05-21,61197,36,2,224,100,2326,1.0,1.634067029429547,"(24.0, 37.5]",Q2
36115,2020-05-22,61197,36,1,225,70,2396,1.0,1.634067029429547,"(24.0, 37.5]",Q2
36115,2020-05-23,61197,36,1,226,213,2609,1.0,1.634067029429547,"(24.0, 37.5]",Q2
36115,2020-05-24,61197,36,2,228,51,2660,1.2857142857142858,2.100943323552275,"(24.0, 37.5]",Q2
36115,2020-05-25,61197,36,0,228,106,2766,1.1428571428571428,1.8675051764909112,"(24.0, 37.5]",Q2
36115,2020-05-26,61197,36,0,228,107,2873,1.0,1.634067029429547,"(24.0, 37.5]",Q2
36115,2020-05-27,61197,36,3,231,293,3166,1.2857142857142858,2.100943323552275,"(24.0, 37.5]",Q2
36115,2020-05-28,61197,36,1,232,340,3506,1.1428571428571428,1.8675051764909112,"(24.0, 37.5]",Q2
36115,2020-05-29,61197,36,3,235,240,3746,1.4285714285714286,2.3343814706136388,"(24.0, 37.5]",Q2
36115,2020-05-30,61197,36,0,235,222,3968,1.2857142857142858,2.100943323552275,"(24.0, 37.5]",Q2
36115,2020-05-31,61197,36,0,235,99,4067,1.0,1.634067029429547,"(24.0, 37.5]",Q2
36115,2020-06-01,61197,36,2,237,81,4148,1.2857142857142858,2.100943323552275,"(24.0, 37.5]",Q2
36115,2020-06-02,61197,36,1,238,270,4418,1.4285714285714286,2.3343814706136388,"(24.0, 37.5]",Q2
36115,2020-06-03,61197,36,0,238,354,4772,1.0,1.634067029429547,"(24.0, 37.5]",Q2
36115,2020-06-04,61197,36,2,240,158,4930,1.1428571428571428,1.8675051764909112,"(24.0, 37.5]",Q2
36115,2020-06-05,61197,36,0,240,254,5184,0.7142857142857143,1.1671907353068194,"(24.0, 37.5]",Q2
36115,2020-06-06,61197,36,0,240,243,5427,0.7142857142857143,1.1671907353068194,"(24.0, 37.5]",Q2
36115,2020-06-07,61197,36,0,240,211,5638,0.7142857142857143,1.1671907353068194,"(24.0, 37.5]",Q2
36117,2020-03-02,90064,22,0,0,0,0,0.0,0.0,"(3.999, 24.0]",Q1
36117,2020-03-03,90064,22,0,0,0,0,0.0,0.0,"(3.999, 24.0]",Q1
36117,2020-03-04,90064,22,0,0,0,0,0.0,0.0,"(3.999, 24.0]",Q1
36117,2020-03-05,90064,22,0,0,0,0,0.0,0.0,"(3.999, 24.0]",Q1
36117,2020-03-06,90064,22,0,0,0,0,0.0,0.0,"(3.999, 24.0]",Q1
36117,2020-03-07,90064,22,0,0,0,0,0.0,0.0,"(3.999, 24.0]",Q1
36117,2020-03-08,90064,22,0,0,0,0,0.0,0.0,"(3.999, 24.0]",Q1
36117,2020-03-09,90064,22,0,0,0,0,0.0,0.0,"(3.999, 24.0]",Q1
36117,2020-03-10,90064,22,0,0,0,0,0.0,0.0,"(3.999, 24.0]",Q1
36117,2020-03-11,90064,22,0,0,0,0,0.0,0.0,"(3.999, 24.0]",Q1
36117,2020-03-12,90064,22,0,0,0,0,0.0,0.0,"(3.999, 24.0]",Q1
36117,2020-03-13,90064,22,0,0,2,2,0.0,0.0,"(3.999, 24.0]",Q1
36117,2020-03-14,90064,22,0,0,1,3,0.0,0.0,"(3.999, 24.0]",Q1
36117,2020-03-15,90064,22,0,0,3,6,0.0,0.0,"(3.999, 24.0]",Q1
36117,2020-03-16,90064,22,0,0,3,9,0.0,0.0,"(3.999, 24.0]",Q1
36117,2020-03-17,90064,22,0,0,10,19,0.0,0.0,"(3.999, 24.0]",Q1
36117,2020-03-18,90064,22,1,1,15,34,0.14285714285714285,0.1586173641600893,"(3.999, 24.0]",Q1
36117,2020-03-19,90064,22,0,1,21,55,0.14285714285714285,0.1586173641600893,"(3.999, 24.0]",Q1
36117,2020-03-20,90064,22,2,3,13,68,0.42857142857142855,0.475852092480268,"(3.999, 24.0]",Q1
36117,2020-03-21,90064,22,0,3,9,77,0.42857142857142855,0.475852092480268,"(3.999, 24.0]",Q1
36117,2020-03-22,90064,22,3,6,14,91,0.8571428571428571,0.951704184960536,"(3.999, 24.0]",Q1
36117,2020-03-23,90064,22,0,6,17,108,0.8571428571428571,0.951704184960536,"(3.999, 24.0]",Q1
36117,2020-03-24,90064,22,1,7,15,123,1.0,1.1103215491206253,"(3.999, 24.0]",Q1
36117,2020-03-25,90064,22,1,8,37,160,1.0,1.1103215491206253,"(3.999, 24.0]",Q1
36117,2020-03-26,90064,22,3,11,27,187,1.4285714285714286,1.5861736416008931,"(3.999, 24.0]",Q1
36117,2020-03-27,90064,22,1,12,32,219,1.2857142857142858,1.4275562774408042,"(3.999, 24.0]",Q1
36117,2020-03-28,90064,22,0,12,13,232,1.2857142857142858,1.4275562774408042,"(3.999, 24.0]",Q1
36117,2020-03-29,90064,22,3,15,24,256,1.2857142857142858,1.4275562774408042,"(3.999, 24.0]",Q1
36117,2020-03-30,90064,22,4,19,28,284,1.8571428571428572,2.0620257340811614,"(3.999, 24.0]",Q1
36117,2020-03-31,90064,22,5,24,33,317,2.4285714285714284,2.696495190721518,"(3.999, 24.0]",Q1
36117,2020-04-01,90064,22,3,27,28,345,2.7142857142857144,3.0137299190416975,"(3.999, 24.0]",Q1
36117,2020-04-02,90064,22,3,30,28,373,2.7142857142857144,3.0137299190416975,"(3.999, 24.0]",Q1
36117,2020-04-03,90064,22,0,30,35,408,2.5714285714285716,2.8551125548816083,"(3.999, 24.0]",Q1
36117,2020-04-04,90064,22,2,32,24,432,2.857142857142857,3.1723472832017863,"(3.999, 24.0]",Q1
36117,2020-04-05,90064,22,2,34,15,447,2.7142857142857144,3.0137299190416975,"(3.999, 24.0]",Q1
36117,2020-04-06,90064,22,1,35,31,478,2.2857142857142856,2.537877826561429,"(3.999, 24.0]",Q1
36117,2020-04-07,90064,22,4,39,46,524,2.142857142857143,2.37926046240134,"(3.999, 24.0]",Q1
36117,2020-04-08,90064,22,0,39,34,558,1.7142857142857142,1.903408369921072,"(3.999, 24.0]",Q1
36117,2020-04-09,90064,22,2,41,34,592,1.5714285714285714,1.7447910057609828,"(3.999, 24.0]",Q1
36117,2020-04-10,90064,22,1,42,17,609,1.7142857142857142,1.903408369921072,"(3.999, 24.0]",Q1
36117,2020-04-11,90064,22,0,42,7,616,1.4285714285714286,1.5861736416008931,"(3.999, 24.0]",Q1
36117,2020-04-12,90064,22,0,42,8,624,1.1428571428571428,1.2689389132807145,"(3.999, 24.0]",Q1
36117,2020-04-13,90064,22,6,48,39,663,1.8571428571428572,2.0620257340811614,"(3.999, 24.0]",Q1
36117,2020-04-14,90064,22,0,48,20,683,1.2857142857142858,1.4275562774408042,"(3.999, 24.0]",Q1
36117,2020-04-15,90064,22,1,49,12,695,1.4285714285714286,1.5861736416008931,"(3.999, 24.0]",Q1
36117,2020-04-16,90064,22,0,49,7,702,1.1428571428571428,1.2689389132807145,"(3.999, 24.0]",Q1
36117,2020-04-17,90064,22,0,49,7,709,1.0,1.1103215491206253,"(3.999, 24.0]",Q1
36117,2020-04-18,90064,22,1,50,6,715,1.1428571428571428,1.2689389132807145,"(3.999, 24.0]",Q1
36117,2020-04-19,90064,22,0,50,2,717,1.1428571428571428,1.2689389132807145,"(3.999, 24.0]",Q1
36117,2020-04-20,90064,22,1,51,8,725,0.42857142857142855,0.475852092480268,"(3.999, 24.0]",Q1
36117,2020-04-21,90064,22,1,52,16,741,0.5714285714285714,0.6344694566403573,"(3.999, 24.0]",Q1
36117,2020-04-22,90064,22,1,53,13,754,0.5714285714285714,0.6344694566403573,"(3.999, 24.0]",Q1
36117,2020-04-23,90064,22,0,53,12,766,0.5714285714285714,0.6344694566403573,"(3.999, 24.0]",Q1
36117,2020-04-24,90064,22,12,65,257,1023,2.2857142857142856,2.537877826561429,"(3.999, 24.0]",Q1
36117,2020-04-25,90064,22,0,65,36,1059,2.142857142857143,2.37926046240134,"(3.999, 24.0]",Q1
36117,2020-04-26,90064,22,4,69,28,1087,2.7142857142857144,3.0137299190416975,"(3.999, 24.0]",Q1
36117,2020-04-27,90064,22,1,70,53,1140,2.7142857142857144,3.0137299190416975,"(3.999, 24.0]",Q1
36117,2020-04-28,90064,22,0,70,45,1185,2.5714285714285716,2.8551125548816083,"(3.999, 24.0]",Q1
36117,2020-04-29,90064,22,1,71,54,1239,2.5714285714285716,2.8551125548816083,"(3.999, 24.0]",Q1
36117,2020-04-30,90064,22,0,71,56,1295,2.5714285714285716,2.8551125548816083,"(3.999, 24.0]",Q1
36117,2020-05-01,90064,22,2,73,43,1338,1.1428571428571428,1.2689389132807145,"(3.999, 24.0]",Q1
36117,2020-05-02,90064,22,2,75,86,1424,1.4285714285714286,1.5861736416008931,"(3.999, 24.0]",Q1
36117,2020-05-03,90064,22,1,76,88,1512,1.0,1.1103215491206253,"(3.999, 24.0]",Q1
36117,2020-05-04,90064,22,2,78,66,1578,1.1428571428571428,1.2689389132807145,"(3.999, 24.0]",Q1
36117,2020-05-05,90064,22,0,78,93,1671,1.1428571428571428,1.2689389132807145,"(3.999, 24.0]",Q1
36117,2020-05-06,90064,22,0,78,93,1764,1.0,1.1103215491206253,"(3.999, 24.0]",Q1
36117,2020-05-07,90064,22,1,79,95,1859,1.1428571428571428,1.2689389132807145,"(3.999, 24.0]",Q1
36117,2020-05-08,90064,22,0,79,63,1922,0.8571428571428571,0.951704184960536,"(3.999, 24.0]",Q1
36117,2020-05-09,90064,22,1,80,101,2023,0.7142857142857143,0.7930868208004466,"(3.999, 24.0]",Q1
36117,2020-05-10,90064,22,1,81,72,2095,0.7142857142857143,0.7930868208004466,"(3.999, 24.0]",Q1
36117,2020-05-11,90064,22,2,83,64,2159,0.7142857142857143,0.7930868208004466,"(3.999, 24.0]",Q1
36117,2020-05-12,90064,22,1,84,168,2327,0.8571428571428571,0.951704184960536,"(3.999, 24.0]",Q1
36117,2020-05-13,90064,22,5,89,120,2447,1.5714285714285714,1.7447910057609828,"(3.999, 24.0]",Q1
36117,2020-05-14,90064,22,2,91,110,2557,1.7142857142857142,1.903408369921072,"(3.999, 24.0]",Q1
36117,2020-05-15,90064,22,1,92,86,2643,1.8571428571428572,2.0620257340811614,"(3.999, 24.0]",Q1
36117,2020-05-16,90064,22,4,96,118,2761,2.2857142857142856,2.537877826561429,"(3.999, 24.0]",Q1
36117,2020-05-17,90064,22,1,97,114,2875,2.2857142857142856,2.537877826561429,"(3.999, 24.0]",Q1
36117,2020-05-18,90064,22,1,98,128,3003,2.142857142857143,2.37926046240134,"(3.999, 24.0]",Q1
36117,2020-05-19,90064,22,5,103,187,3190,2.7142857142857144,3.0137299190416975,"(3.999, 24.0]",Q1
36117,2020-05-20,90064,22,0,103,155,3345,2.0,2.2206430982412506,"(3.999, 24.0]",Q1
36117,2020-05-21,90064,22,1,104,104,3449,1.8571428571428572,2.0620257340811614,"(3.999, 24.0]",Q1
36117,2020-05-22,90064,22,3,107,163,3612,2.142857142857143,2.37926046240134,"(3.999, 24.0]",Q1
36117,2020-05-23,90064,22,1,108,107,3719,1.7142857142857142,1.903408369921072,"(3.999, 24.0]",Q1
36117,2020-05-24,90064,22,1,109,106,3825,1.7142857142857142,1.903408369921072,"(3.999, 24.0]",Q1
36117,2020-05-25,90064,22,1,110,170,3995,1.7142857142857142,1.903408369921072,"(3.999, 24.0]",Q1
36117,2020-05-26,90064,22,0,110,339,4334,1.0,1.1103215491206253,"(3.999, 24.0]",Q1
36117,2020-05-27,90064,22,2,112,303,4637,1.2857142857142858,1.4275562774408042,"(3.999, 24.0]",Q1
36117,2020-05-28,90064,22,1,113,290,4927,1.2857142857142858,1.4275562774408042,"(3.999, 24.0]",Q1
36117,2020-05-29,90064,22,0,113,299,5226,0.8571428571428571,0.951704184960536,"(3.999, 24.0]",Q1
36117,2020-05-30,90064,22,2,115,284,5510,1.0,1.1103215491206253,"(3.999, 24.0]",Q1
36117,2020-05-31,90064,22,1,116,228,5738,1.0,1.1103215491206253,"(3.999, 24.0]",Q1
36117,2020-06-01,90064,22,0,116,216,5954,0.8571428571428571,0.951704184960536,"(3.999, 24.0]",Q1
36117,2020-06-02,90064,22,4,120,396,6350,1.4285714285714286,1.5861736416008931,"(3.999, 24.0]",Q1
36117,2020-06-03,90064,22,1,121,468,6818,1.2857142857142858,1.4275562774408042,"(3.999, 24.0]",Q1
36117,2020-06-04,90064,22,1,122,323,7141,1.2857142857142858,1.4275562774408042,"(3.999, 24.0]",Q1
36117,2020-06-05,90064,22,1,123,409,7550,1.4285714285714286,1.5861736416008931,"(3.999, 24.0]",Q1
36117,2020-06-06,90064,22,1,124,362,7912,1.2857142857142858,1.4275562774408042,"(3.999, 24.0]",Q1
36117,2020-06-07,90064,22,1,125,322,8234,1.2857142857142858,1.4275562774408042,"(3.999, 24.0]",Q1
36119,2020-03-02,967612,47,1,1,1,1,1.0,0.10334720941865128,"(37.5, 52.0]",Q3
36119,2020-03-03,967612,47,0,1,1,2,0.0,0.0,"(37.5, 52.0]",Q3
36119,2020-03-04,967612,47,0,1,0,2,0.0,0.0,"(37.5, 52.0]",Q3
36119,2020-03-05,967612,47,19,20,42,44,19.0,1.9635969789543741,"(37.5, 52.0]",Q3
36119,2020-03-06,967612,47,0,20,9,53,0.0,0.0,"(37.5, 52.0]",Q3
36119,2020-03-07,967612,47,22,42,110,163,22.0,2.273638607210328,"(37.5, 52.0]",Q3
36119,2020-03-08,967612,47,18,60,207,370,8.571428571428571,0.8858332235884395,"(37.5, 52.0]",Q3
36119,2020-03-09,967612,47,42,102,222,592,14.428571428571429,1.4911525930405398,"(37.5, 52.0]",Q3
36119,2020-03-10,967612,47,9,111,177,769,15.714285714285714,1.6240275765788057,"(37.5, 52.0]",Q3
36119,2020-03-11,967612,47,21,132,183,952,18.714285714285715,1.9340692048347599,"(37.5, 52.0]",Q3
36119,2020-03-12,967612,47,19,151,108,1060,18.714285714285715,1.9340692048347599,"(37.5, 52.0]",Q3
36119,2020-03-13,967612,47,20,171,209,1269,21.571428571428573,2.229346946030906,"(37.5, 52.0]",Q3
36119,2020-03-14,967612,47,11,182,220,1489,20.0,2.0669441883730255,"(37.5, 52.0]",Q3
36119,2020-03-15,967612,47,41,223,372,1861,23.285714285714285,2.406513590748594,"(37.5, 52.0]",Q3
36119,2020-03-16,967612,47,157,380,1219,3080,39.714285714285715,4.1043606026264365,"(37.5, 52.0]",Q3
36119,2020-03-17,967612,47,158,538,1026,4106,61.0,6.304179774537728,"(37.5, 52.0]",Q3
36119,2020-03-18,967612,47,261,799,1588,5694,95.28571428571429,9.847512668891486,"(37.5, 52.0]",Q3
36119,2020-03-19,967612,47,292,1091,1483,7177,134.28571428571428,13.878053836218886,"(37.5, 52.0]",Q3
36119,2020-03-20,967612,47,296,1387,1459,8636,173.71428571428572,17.952886664725707,"(37.5, 52.0]",Q3
36119,2020-03-21,967612,47,486,1873,2011,10647,241.57142857142858,24.965733018134188,"(37.5, 52.0]",Q3
36119,2020-03-22,967612,47,1021,2894,4037,14684,381.57142857142856,39.43434233674537,"(37.5, 52.0]",Q3
36119,2020-03-23,967612,47,997,3891,3282,17966,501.57142857142856,51.83600746698352,"(37.5, 52.0]",Q3
36119,2020-03-24,967612,47,800,4691,2371,20337,593.2857142857143,61.31442295937982,"(37.5, 52.0]",Q3
36119,2020-03-25,967612,47,1253,5944,5951,26288,735.0,75.96019892270868,"(37.5, 52.0]",Q3
36119,2020-03-26,967612,47,1243,7187,3227,29515,870.8571428571429,90.00065551658545,"(37.5, 52.0]",Q3
36119,2020-03-27,967612,47,688,7875,1588,31103,926.8571428571429,95.78809924402992,"(37.5, 52.0]",Q3
36119,2020-03-28,967612,47,644,8519,1410,32513,949.4285714285714,98.1207933994795,"(37.5, 52.0]",Q3
36119,2020-03-29,967612,47,807,9326,1595,34108,918.8571428571429,94.96132156868072,"(37.5, 52.0]",Q3
36119,2020-03-30,967612,47,641,9967,1515,35623,868.0,89.70537777538931,"(37.5, 52.0]",Q3
36119,2020-03-31,967612,47,716,10683,1567,37190,856.0,88.4652112623655,"(37.5, 52.0]",Q3
36119,2020-04-01,967612,47,884,11567,1891,39081,803.2857142857143,83.01733693729659,"(37.5, 52.0]",Q3
36119,2020-04-02,967612,47,784,12351,1632,40713,737.7142857142857,76.24071277684502,"(37.5, 52.0]",Q3
36119,2020-04-03,967612,47,730,13081,1621,42334,743.7142857142857,76.86079603335693,"(37.5, 52.0]",Q3
36119,2020-04-04,967612,47,642,13723,1621,43955,743.4285714285714,76.83126825923732,"(37.5, 52.0]",Q3
36119,2020-04-05,967612,47,571,14294,1398,45353,709.7142857142857,73.3469909131228,"(37.5, 52.0]",Q3
36119,2020-04-06,967612,47,510,14804,1348,46701,691.0,71.41292170828802,"(37.5, 52.0]",Q3
36119,2020-04-07,967612,47,1083,15887,2647,49348,743.4285714285714,76.83126825923732,"(37.5, 52.0]",Q3
36119,2020-04-08,967612,47,1117,17004,2889,52237,776.7142857142857,80.27125394417243,"(37.5, 52.0]",Q3
36119,2020-04-09,967612,47,1073,18077,2911,55148,818.0,84.53801730445674,"(37.5, 52.0]",Q3
36119,2020-04-10,967612,47,652,18729,1679,56827,806.8571428571429,83.38643411379178,"(37.5, 52.0]",Q3
36119,2020-04-11,967612,47,584,19313,1472,58299,798.5714285714286,82.53012866432294,"(37.5, 52.0]",Q3
36119,2020-04-12,967612,47,473,19786,1163,59462,784.5714285714286,81.08326773246183,"(37.5, 52.0]",Q3
36119,2020-04-13,967612,47,405,20191,1145,60607,769.5714285714286,79.53305959118205,"(37.5, 52.0]",Q3
36119,2020-04-14,967612,47,756,20947,2019,62626,722.8571428571429,74.70526852262508,"(37.5, 52.0]",Q3
36119,2020-04-15,967612,47,881,21828,2642,65268,689.1428571428571,71.22099117651054,"(37.5, 52.0]",Q3
36119,2020-04-16,967612,47,648,22476,2042,67310,628.4285714285714,64.94633917609242,"(37.5, 52.0]",Q3
36119,2020-04-17,967612,47,703,23179,2298,69608,635.7142857142857,65.69929741614258,"(37.5, 52.0]",Q3
36119,2020-04-18,967612,47,624,23803,2133,71741,641.4285714285714,66.28985289853489,"(37.5, 52.0]",Q3
36119,2020-04-19,967612,47,503,24306,1599,73340,645.7142857142857,66.7327695103291,"(37.5, 52.0]",Q3
36119,2020-04-20,967612,47,350,24656,1208,74548,637.8571428571429,65.92075572203971,"(37.5, 52.0]",Q3
36119,2020-04-21,967612,47,620,25276,2016,76564,618.4285714285714,63.912867081905915,"(37.5, 52.0]",Q3
36119,2020-04-22,967612,47,683,25959,2317,78881,590.1428571428571,60.98961744406406,"(37.5, 52.0]",Q3
36119,2020-04-23,967612,47,674,26633,2672,81553,593.8571428571429,61.373478507619055,"(37.5, 52.0]",Q3
36119,2020-04-24,967612,47,598,27231,2468,84021,578.8571428571429,59.82327036633928,"(37.5, 52.0]",Q3
36119,2020-04-25,967612,47,433,27664,1951,85972,551.5714285714286,57.00336793791608,"(37.5, 52.0]",Q3
36119,2020-04-26,967612,47,343,28007,1764,87736,528.7142857142857,54.64114600834691,"(37.5, 52.0]",Q3
36119,2020-04-27,967612,47,238,28245,1408,89144,512.7142857142857,52.98759065764848,"(37.5, 52.0]",Q3
36119,2020-04-28,967612,47,381,28626,1843,90987,478.57142857142856,49.459021650354536,"(37.5, 52.0]",Q3
36119,2020-04-29,967612,47,344,28970,1842,92829,430.14285714285717,44.45406393707986,"(37.5, 52.0]",Q3
36119,2020-04-30,967612,47,262,29232,1613,94442,371.2857142857143,38.37134246843924,"(37.5, 52.0]",Q3
36119,2020-05-01,967612,47,394,29626,2359,96801,342.14285714285717,35.35950950823855,"(37.5, 52.0]",Q3
36119,2020-05-02,967612,47,258,29884,1809,98610,317.14285714285717,32.77582927277226,"(37.5, 52.0]",Q3
36119,2020-05-03,967612,47,213,30097,1662,100272,298.57142857142856,30.856523954997307,"(37.5, 52.0]",Q3
36119,2020-05-04,967612,47,143,30240,1225,101497,285.0,29.45395468431561,"(37.5, 52.0]",Q3
36119,2020-05-05,967612,47,186,30426,1434,102931,257.14285714285717,26.574996707653188,"(37.5, 52.0]",Q3
36119,2020-05-06,967612,47,282,30708,2311,105242,248.28571428571428,25.659635709945128,"(37.5, 52.0]",Q3
36119,2020-05-07,967612,47,197,30905,2224,107466,239.0,24.699983051057657,"(37.5, 52.0]",Q3
36119,2020-05-08,967612,47,182,31087,1936,109402,208.71428571428572,21.570038994378503,"(37.5, 52.0]",Q3
36119,2020-05-09,967612,47,207,31294,1940,111342,201.42857142857142,20.817080754328327,"(37.5, 52.0]",Q3
36119,2020-05-10,967612,47,90,31384,1321,112663,183.85714285714286,19.00112264597203,"(37.5, 52.0]",Q3
36119,2020-05-11,967612,47,88,31472,984,113647,176.0,18.189108857682623,"(37.5, 52.0]",Q3
36119,2020-05-12,967612,47,139,31611,1925,115572,169.28571428571428,17.49520616587168,"(37.5, 52.0]",Q3
36119,2020-05-13,967612,47,181,31792,2450,118022,154.85714285714286,16.004053572831143,"(37.5, 52.0]",Q3
36119,2020-05-14,967612,47,151,31943,2024,120046,148.28571428571428,15.324914768080005,"(37.5, 52.0]",Q3
36119,2020-05-15,967612,47,154,32097,2059,122105,144.28571428571428,14.911525930405398,"(37.5, 52.0]",Q3
36119,2020-05-16,967612,47,127,32224,1940,124045,132.85714285714286,13.730414965620811,"(37.5, 52.0]",Q3
36119,2020-05-17,967612,47,99,32323,1326,125371,134.14285714285714,13.863289949159077,"(37.5, 52.0]",Q3
36119,2020-05-18,967612,47,79,32402,1125,126496,132.85714285714286,13.730414965620811,"(37.5, 52.0]",Q3
36119,2020-05-19,967612,47,115,32517,1867,128363,129.42857142857142,13.376081676185436,"(37.5, 52.0]",Q3
36119,2020-05-20,967612,47,156,32673,2671,131034,125.85714285714286,13.006984499690255,"(37.5, 52.0]",Q3
36119,2020-05-21,967612,47,94,32767,2350,133384,117.71428571428571,12.165442937281236,"(37.5, 52.0]",Q3
36119,2020-05-22,967612,47,114,32881,3234,136618,112.0,11.574887454888943,"(37.5, 52.0]",Q3
36119,2020-05-23,967612,47,87,32968,2542,139160,106.28571428571429,10.984331972496651,"(37.5, 52.0]",Q3
36119,2020-05-24,967612,47,81,33049,2323,141483,103.71428571428571,10.718582005420117,"(37.5, 52.0]",Q3
36119,2020-05-25,967612,47,58,33107,1695,143178,100.71428571428571,10.408540377164163,"(37.5, 52.0]",Q3
36119,2020-05-26,967612,47,79,33186,2207,145385,95.57142857142857,9.8770404430111,"(37.5, 52.0]",Q3
36119,2020-05-27,967612,47,107,33293,3266,148651,88.57142857142857,9.153609977080542,"(37.5, 52.0]",Q3
36119,2020-05-28,967612,47,56,33349,3203,151854,83.14285714285714,8.592582268807863,"(37.5, 52.0]",Q3
36119,2020-05-29,967612,47,80,33429,3388,155242,78.28571428571429,8.090610108774415,"(37.5, 52.0]",Q3
36119,2020-05-30,967612,47,52,33481,3290,158532,73.28571428571429,7.573874061681159,"(37.5, 52.0]",Q3
36119,2020-05-31,967612,47,71,33552,3376,161908,71.85714285714286,7.4262351910830855,"(37.5, 52.0]",Q3
36119,2020-06-01,967612,47,81,33633,3183,165091,75.14285714285714,7.765804593458653,"(37.5, 52.0]",Q3
36119,2020-06-02,967612,47,58,33691,3253,168344,72.14285714285714,7.455762965202699,"(37.5, 52.0]",Q3
36119,2020-06-03,967612,47,76,33767,3524,171868,67.71428571428571,6.998082466348671,"(37.5, 52.0]",Q3
36119,2020-06-04,967612,47,87,33854,4216,176084,72.14285714285714,7.455762965202699,"(37.5, 52.0]",Q3
36119,2020-06-05,967612,47,70,33924,3979,180063,70.71428571428571,7.308124094604625,"(37.5, 52.0]",Q3
36119,2020-06-06,967612,47,30,33954,3162,183225,67.57142857142857,6.983318579288865,"(37.5, 52.0]",Q3
36119,2020-06-07,967612,47,46,34000,3336,186561,64.0,6.614221402793682,"(37.5, 52.0]",Q3
36121,2020-03-02,40085,23,0,0,0,0,0.0,0.0,"(3.999, 24.0]",Q1
36121,2020-03-03,40085,23,0,0,0,0,0.0,0.0,"(3.999, 24.0]",Q1
36121,2020-03-04,40085,23,0,0,0,0,0.0,0.0,"(3.999, 24.0]",Q1
36121,2020-03-05,40085,23,0,0,0,0,0.0,0.0,"(3.999, 24.0]",Q1
36121,2020-03-06,40085,23,0,0,0,0,0.0,0.0,"(3.999, 24.0]",Q1
36121,2020-03-07,40085,23,0,0,0,0,0.0,0.0,"(3.999, 24.0]",Q1
36121,2020-03-08,40085,23,0,0,0,0,0.0,0.0,"(3.999, 24.0]",Q1
36121,2020-03-09,40085,23,0,0,0,0,0.0,0.0,"(3.999, 24.0]",Q1
36121,2020-03-10,40085,23,0,0,0,0,0.0,0.0,"(3.999, 24.0]",Q1
36121,2020-03-11,40085,23,0,0,0,0,0.0,0.0,"(3.999, 24.0]",Q1
36121,2020-03-12,40085,23,0,0,0,0,0.0,0.0,"(3.999, 24.0]",Q1
36121,2020-03-13,40085,23,0,0,0,0,0.0,0.0,"(3.999, 24.0]",Q1
36121,2020-03-14,40085,23,0,0,0,0,0.0,0.0,"(3.999, 24.0]",Q1
36121,2020-03-15,40085,23,1,1,3,3,0.14285714285714285,0.35638553787487304,"(3.999, 24.0]",Q1
36121,2020-03-16,40085,23,0,1,0,3,0.14285714285714285,0.35638553787487304,"(3.999, 24.0]",Q1
36121,2020-03-17,40085,23,0,1,2,5,0.14285714285714285,0.35638553787487304,"(3.999, 24.0]",Q1
36121,2020-03-18,40085,23,1,2,6,11,0.2857142857142857,0.7127710757497461,"(3.999, 24.0]",Q1
36121,2020-03-19,40085,23,0,2,3,14,0.2857142857142857,0.7127710757497461,"(3.999, 24.0]",Q1
36121,2020-03-20,40085,23,0,2,0,14,0.2857142857142857,0.7127710757497461,"(3.999, 24.0]",Q1
36121,2020-03-21,40085,23,0,2,4,18,0.2857142857142857,0.7127710757497461,"(3.999, 24.0]",Q1
36121,2020-03-22,40085,23,2,4,11,29,0.42857142857142855,1.0691566136246191,"(3.999, 24.0]",Q1
36121,2020-03-23,40085,23,0,4,8,37,0.42857142857142855,1.0691566136246191,"(3.999, 24.0]",Q1
36121,2020-03-24,40085,23,0,4,7,44,0.42857142857142855,1.0691566136246191,"(3.999, 24.0]",Q1
36121,2020-03-25,40085,23,3,7,9,53,0.7142857142857143,1.7819276893743652,"(3.999, 24.0]",Q1
36121,2020-03-26,40085,23,0,7,14,67,0.7142857142857143,1.7819276893743652,"(3.999, 24.0]",Q1
36121,2020-03-27,40085,23,0,7,15,82,0.7142857142857143,1.7819276893743652,"(3.999, 24.0]",Q1
36121,2020-03-28,40085,23,1,8,13,95,0.8571428571428571,2.1383132272492382,"(3.999, 24.0]",Q1
36121,2020-03-29,40085,23,0,8,7,102,0.5714285714285714,1.4255421514994921,"(3.999, 24.0]",Q1
36121,2020-03-30,40085,23,1,9,13,115,0.7142857142857143,1.7819276893743652,"(3.999, 24.0]",Q1
36121,2020-03-31,40085,23,1,10,10,125,0.8571428571428571,2.1383132272492382,"(3.999, 24.0]",Q1
36121,2020-04-01,40085,23,4,14,12,137,1.0,2.4946987651241113,"(3.999, 24.0]",Q1
36121,2020-04-02,40085,23,1,15,11,148,1.1428571428571428,2.8510843029989843,"(3.999, 24.0]",Q1
36121,2020-04-03,40085,23,3,18,11,159,1.5714285714285714,3.920240916623603,"(3.999, 24.0]",Q1
36121,2020-04-04,40085,23,4,22,16,175,2.0,4.9893975302482225,"(3.999, 24.0]",Q1
36121,2020-04-05,40085,23,1,23,6,181,2.142857142857143,5.345783068123096,"(3.999, 24.0]",Q1
36121,2020-04-06,40085,23,0,23,7,188,2.0,4.9893975302482225,"(3.999, 24.0]",Q1
36121,2020-04-07,40085,23,4,27,18,206,2.4285714285714284,6.058554143872841,"(3.999, 24.0]",Q1
36121,2020-04-08,40085,23,2,29,12,218,2.142857142857143,5.345783068123096,"(3.999, 24.0]",Q1
36121,2020-04-09,40085,23,1,30,13,231,2.142857142857143,5.345783068123096,"(3.999, 24.0]",Q1
36121,2020-04-10,40085,23,1,31,12,243,1.8571428571428572,4.6330119923733495,"(3.999, 24.0]",Q1
36121,2020-04-11,40085,23,0,31,2,245,1.2857142857142858,3.2074698408738573,"(3.999, 24.0]",Q1
36121,2020-04-12,40085,23,0,31,2,247,1.1428571428571428,2.8510843029989843,"(3.999, 24.0]",Q1
36121,2020-04-13,40085,23,1,32,21,268,1.2857142857142858,3.2074698408738573,"(3.999, 24.0]",Q1
36121,2020-04-14,40085,23,2,34,9,277,1.0,2.4946987651241113,"(3.999, 24.0]",Q1
36121,2020-04-15,40085,23,0,34,8,285,0.7142857142857143,1.7819276893743652,"(3.999, 24.0]",Q1
36121,2020-04-16,40085,23,1,35,11,296,0.7142857142857143,1.7819276893743652,"(3.999, 24.0]",Q1
36121,2020-04-17,40085,23,1,36,6,302,0.7142857142857143,1.7819276893743652,"(3.999, 24.0]",Q1
36121,2020-04-18,40085,23,0,36,6,308,0.7142857142857143,1.7819276893743652,"(3.999, 24.0]",Q1
36121,2020-04-19,40085,23,0,36,4,312,0.7142857142857143,1.7819276893743652,"(3.999, 24.0]",Q1
36121,2020-04-20,40085,23,0,36,6,318,0.5714285714285714,1.4255421514994921,"(3.999, 24.0]",Q1
36121,2020-04-21,40085,23,4,40,14,332,0.8571428571428571,2.1383132272492382,"(3.999, 24.0]",Q1
36121,2020-04-22,40085,23,1,41,15,347,1.0,2.4946987651241113,"(3.999, 24.0]",Q1
36121,2020-04-23,40085,23,2,43,18,365,1.1428571428571428,2.8510843029989843,"(3.999, 24.0]",Q1
36121,2020-04-24,40085,23,14,57,117,482,3.0,7.484096295372334,"(3.999, 24.0]",Q1
36121,2020-04-25,40085,23,2,59,19,501,3.2857142857142856,8.19686737112208,"(3.999, 24.0]",Q1
36121,2020-04-26,40085,23,4,63,15,516,3.857142857142857,9.622409522621572,"(3.999, 24.0]",Q1
36121,2020-04-27,40085,23,0,63,9,525,3.857142857142857,9.622409522621572,"(3.999, 24.0]",Q1
36121,2020-04-28,40085,23,2,65,26,551,3.5714285714285716,8.909638446871828,"(3.999, 24.0]",Q1
36121,2020-04-29,40085,23,2,67,17,568,3.7142857142857144,9.266023984746699,"(3.999, 24.0]",Q1
36121,2020-04-30,40085,23,1,68,16,584,3.5714285714285716,8.909638446871828,"(3.999, 24.0]",Q1
36121,2020-05-01,40085,23,1,69,32,616,1.7142857142857142,4.2766264544984764,"(3.999, 24.0]",Q1
36121,2020-05-02,40085,23,0,69,15,631,1.4285714285714286,3.5638553787487304,"(3.999, 24.0]",Q1
36121,2020-05-03,40085,23,0,69,16,647,0.8571428571428571,2.1383132272492382,"(3.999, 24.0]",Q1
36121,2020-05-04,40085,23,1,70,24,671,1.0,2.4946987651241113,"(3.999, 24.0]",Q1
36121,2020-05-05,40085,23,0,70,42,713,0.7142857142857143,1.7819276893743652,"(3.999, 24.0]",Q1
36121,2020-05-06,40085,23,1,71,22,735,0.5714285714285714,1.4255421514994921,"(3.999, 24.0]",Q1
36121,2020-05-07,40085,23,2,73,130,865,0.7142857142857143,1.7819276893743652,"(3.999, 24.0]",Q1
36121,2020-05-08,40085,23,2,75,187,1052,0.8571428571428571,2.1383132272492382,"(3.999, 24.0]",Q1
36121,2020-05-09,40085,23,2,77,26,1078,1.1428571428571428,2.8510843029989843,"(3.999, 24.0]",Q1
36121,2020-05-10,40085,23,0,77,39,1117,1.1428571428571428,2.8510843029989843,"(3.999, 24.0]",Q1
36121,2020-05-11,40085,23,0,77,24,1141,1.0,2.4946987651241113,"(3.999, 24.0]",Q1
36121,2020-05-12,40085,23,0,77,63,1204,1.0,2.4946987651241113,"(3.999, 24.0]",Q1
36121,2020-05-13,40085,23,0,77,41,1245,0.8571428571428571,2.1383132272492382,"(3.999, 24.0]",Q1
36121,2020-05-14,40085,23,0,77,106,1351,0.5714285714285714,1.4255421514994921,"(3.999, 24.0]",Q1
36121,2020-05-15,40085,23,1,78,28,1379,0.42857142857142855,1.0691566136246191,"(3.999, 24.0]",Q1
36121,2020-05-16,40085,23,0,78,43,1422,0.14285714285714285,0.35638553787487304,"(3.999, 24.0]",Q1
36121,2020-05-17,40085,23,1,79,56,1478,0.2857142857142857,0.7127710757497461,"(3.999, 24.0]",Q1
36121,2020-05-18,40085,23,0,79,27,1505,0.2857142857142857,0.7127710757497461,"(3.999, 24.0]",Q1
36121,2020-05-19,40085,23,0,79,60,1565,0.2857142857142857,0.7127710757497461,"(3.999, 24.0]",Q1
36121,2020-05-20,40085,23,0,79,64,1629,0.2857142857142857,0.7127710757497461,"(3.999, 24.0]",Q1
36121,2020-05-21,40085,23,0,79,46,1675,0.2857142857142857,0.7127710757497461,"(3.999, 24.0]",Q1
36121,2020-05-22,40085,23,1,80,150,1825,0.2857142857142857,0.7127710757497461,"(3.999, 24.0]",Q1
36121,2020-05-23,40085,23,1,81,113,1938,0.42857142857142855,1.0691566136246191,"(3.999, 24.0]",Q1
36121,2020-05-24,40085,23,1,82,42,1980,0.42857142857142855,1.0691566136246191,"(3.999, 24.0]",Q1
36121,2020-05-25,40085,23,0,82,29,2009,0.42857142857142855,1.0691566136246191,"(3.999, 24.0]",Q1
36121,2020-05-26,40085,23,0,82,42,2051,0.42857142857142855,1.0691566136246191,"(3.999, 24.0]",Q1
36121,2020-05-27,40085,23,0,82,77,2128,0.42857142857142855,1.0691566136246191,"(3.999, 24.0]",Q1
36121,2020-05-28,40085,23,0,82,66,2194,0.42857142857142855,1.0691566136246191,"(3.999, 24.0]",Q1
36121,2020-05-29,40085,23,2,84,90,2284,0.5714285714285714,1.4255421514994921,"(3.999, 24.0]",Q1
36121,2020-05-30,40085,23,2,86,45,2329,0.7142857142857143,1.7819276893743652,"(3.999, 24.0]",Q1
36121,2020-05-31,40085,23,0,86,85,2414,0.5714285714285714,1.4255421514994921,"(3.999, 24.0]",Q1
36121,2020-06-01,40085,23,0,86,229,2643,0.5714285714285714,1.4255421514994921,"(3.999, 24.0]",Q1
36121,2020-06-02,40085,23,1,87,91,2734,0.7142857142857143,1.7819276893743652,"(3.999, 24.0]",Q1
36121,2020-06-03,40085,23,0,87,122,2856,0.7142857142857143,1.7819276893743652,"(3.999, 24.0]",Q1
36121,2020-06-04,40085,23,1,88,67,2923,0.8571428571428571,2.1383132272492382,"(3.999, 24.0]",Q1
36121,2020-06-05,40085,23,1,89,129,3052,0.7142857142857143,1.7819276893743652,"(3.999, 24.0]",Q1
36121,2020-06-06,40085,23,0,89,124,3176,0.42857142857142855,1.0691566136246191,"(3.999, 24.0]",Q1
36121,2020-06-07,40085,23,1,90,127,3303,0.5714285714285714,1.4255421514994921,"(3.999, 24.0]",Q1
36123,2020-03-02,24841,35,0,0,0,0,0.0,0.0,"(24.0, 37.5]",Q2
36123,2020-03-03,24841,35,0,0,0,0,0.0,0.0,"(24.0, 37.5]",Q2
36123,2020-03-04,24841,35,0,0,0,0,0.0,0.0,"(24.0, 37.5]",Q2
36123,2020-03-05,24841,35,0,0,0,0,0.0,0.0,"(24.0, 37.5]",Q2
36123,2020-03-06,24841,35,0,0,0,0,0.0,0.0,"(24.0, 37.5]",Q2
36123,2020-03-07,24841,35,0,0,0,0,0.0,0.0,"(24.0, 37.5]",Q2
36123,2020-03-08,24841,35,0,0,0,0,0.0,0.0,"(24.0, 37.5]",Q2
36123,2020-03-09,24841,35,0,0,0,0,0.0,0.0,"(24.0, 37.5]",Q2
36123,2020-03-10,24841,35,0,0,0,0,0.0,0.0,"(24.0, 37.5]",Q2
36123,2020-03-11,24841,35,0,0,0,0,0.0,0.0,"(24.0, 37.5]",Q2
36123,2020-03-12,24841,35,0,0,0,0,0.0,0.0,"(24.0, 37.5]",Q2
36123,2020-03-13,24841,35,0,0,1,1,0.0,0.0,"(24.0, 37.5]",Q2
36123,2020-03-14,24841,35,0,0,2,3,0.0,0.0,"(24.0, 37.5]",Q2
36123,2020-03-15,24841,35,0,0,1,4,0.0,0.0,"(24.0, 37.5]",Q2
36123,2020-03-16,24841,35,0,0,0,4,0.0,0.0,"(24.0, 37.5]",Q2
36123,2020-03-17,24841,35,0,0,0,4,0.0,0.0,"(24.0, 37.5]",Q2
36123,2020-03-18,24841,35,0,0,3,7,0.0,0.0,"(24.0, 37.5]",Q2
36123,2020-03-19,24841,35,0,0,1,8,0.0,0.0,"(24.0, 37.5]",Q2
36123,2020-03-20,24841,35,0,0,2,10,0.0,0.0,"(24.0, 37.5]",Q2
36123,2020-03-21,24841,35,0,0,3,13,0.0,0.0,"(24.0, 37.5]",Q2
36123,2020-03-22,24841,35,0,0,3,16,0.0,0.0,"(24.0, 37.5]",Q2
36123,2020-03-23,24841,35,0,0,3,19,0.0,0.0,"(24.0, 37.5]",Q2
36123,2020-03-24,24841,35,0,0,3,22,0.0,0.0,"(24.0, 37.5]",Q2
36123,2020-03-25,24841,35,0,0,1,23,0.0,0.0,"(24.0, 37.5]",Q2
36123,2020-03-26,24841,35,0,0,2,25,0.0,0.0,"(24.0, 37.5]",Q2
36123,2020-03-27,24841,35,0,0,10,35,0.0,0.0,"(24.0, 37.5]",Q2
36123,2020-03-28,24841,35,0,0,7,42,0.0,0.0,"(24.0, 37.5]",Q2
36123,2020-03-29,24841,35,0,0,2,44,0.0,0.0,"(24.0, 37.5]",Q2
36123,2020-03-30,24841,35,0,0,3,47,0.0,0.0,"(24.0, 37.5]",Q2
36123,2020-03-31,24841,35,0,0,7,54,0.0,0.0,"(24.0, 37.5]",Q2
36123,2020-04-01,24841,35,1,1,8,62,0.14285714285714285,0.5750861191463422,"(24.0, 37.5]",Q2
36123,2020-04-02,24841,35,0,1,7,69,0.14285714285714285,0.5750861191463422,"(24.0, 37.5]",Q2
36123,2020-04-03,24841,35,0,1,3,72,0.14285714285714285,0.5750861191463422,"(24.0, 37.5]",Q2
36123,2020-04-04,24841,35,0,1,6,78,0.14285714285714285,0.5750861191463422,"(24.0, 37.5]",Q2
36123,2020-04-05,24841,35,0,1,2,80,0.14285714285714285,0.5750861191463422,"(24.0, 37.5]",Q2
36123,2020-04-06,24841,35,0,1,3,83,0.14285714285714285,0.5750861191463422,"(24.0, 37.5]",Q2
36123,2020-04-07,24841,35,0,1,5,88,0.14285714285714285,0.5750861191463422,"(24.0, 37.5]",Q2
36123,2020-04-08,24841,35,0,1,7,95,0.0,0.0,"(24.0, 37.5]",Q2
36123,2020-04-09,24841,35,1,2,3,98,0.14285714285714285,0.5750861191463422,"(24.0, 37.5]",Q2
36123,2020-04-10,24841,35,0,2,5,103,0.14285714285714285,0.5750861191463422,"(24.0, 37.5]",Q2
36123,2020-04-11,24841,35,1,3,6,109,0.2857142857142857,1.1501722382926844,"(24.0, 37.5]",Q2
36123,2020-04-12,24841,35,1,4,4,113,0.42857142857142855,1.7252583574390266,"(24.0, 37.5]",Q2
36123,2020-04-13,24841,35,2,6,5,118,0.7142857142857143,2.875430595731711,"(24.0, 37.5]",Q2
36123,2020-04-14,24841,35,0,6,5,123,0.7142857142857143,2.875430595731711,"(24.0, 37.5]",Q2
36123,2020-04-15,24841,35,1,7,2,125,0.8571428571428571,3.450516714878053,"(24.0, 37.5]",Q2
36123,2020-04-16,24841,35,1,8,10,135,0.8571428571428571,3.450516714878053,"(24.0, 37.5]",Q2
36123,2020-04-17,24841,35,1,9,28,163,1.0,4.0256028340243954,"(24.0, 37.5]",Q2
36123,2020-04-18,24841,35,0,9,2,165,0.8571428571428571,3.450516714878053,"(24.0, 37.5]",Q2
36123,2020-04-19,24841,35,1,10,13,178,0.8571428571428571,3.450516714878053,"(24.0, 37.5]",Q2
36123,2020-04-20,24841,35,0,10,1,179,0.5714285714285714,2.300344476585369,"(24.0, 37.5]",Q2
36123,2020-04-21,24841,35,1,11,1,180,0.7142857142857143,2.875430595731711,"(24.0, 37.5]",Q2
36123,2020-04-22,24841,35,0,11,8,188,0.5714285714285714,2.300344476585369,"(24.0, 37.5]",Q2
36123,2020-04-23,24841,35,0,11,5,193,0.42857142857142855,1.7252583574390266,"(24.0, 37.5]",Q2
36123,2020-04-24,24841,35,5,16,41,234,1.0,4.0256028340243954,"(24.0, 37.5]",Q2
36123,2020-04-25,24841,35,1,17,4,238,1.1428571428571428,4.600688953170738,"(24.0, 37.5]",Q2
36123,2020-04-26,24841,35,0,17,3,241,1.0,4.0256028340243954,"(24.0, 37.5]",Q2
36123,2020-04-27,24841,35,0,17,3,244,1.0,4.0256028340243954,"(24.0, 37.5]",Q2
36123,2020-04-28,24841,35,0,17,8,252,0.8571428571428571,3.450516714878053,"(24.0, 37.5]",Q2
36123,2020-04-29,24841,35,1,18,10,262,1.0,4.0256028340243954,"(24.0, 37.5]",Q2
36123,2020-04-30,24841,35,0,18,12,274,1.0,4.0256028340243954,"(24.0, 37.5]",Q2
36123,2020-05-01,24841,35,0,18,13,287,0.2857142857142857,1.1501722382926844,"(24.0, 37.5]",Q2
36123,2020-05-02,24841,35,1,19,23,310,0.2857142857142857,1.1501722382926844,"(24.0, 37.5]",Q2
36123,2020-05-03,24841,35,0,19,9,319,0.2857142857142857,1.1501722382926844,"(24.0, 37.5]",Q2
36123,2020-05-04,24841,35,0,19,7,326,0.2857142857142857,1.1501722382926844,"(24.0, 37.5]",Q2
36123,2020-05-05,24841,35,0,19,13,339,0.2857142857142857,1.1501722382926844,"(24.0, 37.5]",Q2
36123,2020-05-06,24841,35,0,19,13,352,0.14285714285714285,0.5750861191463422,"(24.0, 37.5]",Q2
36123,2020-05-07,24841,35,1,20,12,364,0.2857142857142857,1.1501722382926844,"(24.0, 37.5]",Q2
36123,2020-05-08,24841,35,0,20,24,388,0.2857142857142857,1.1501722382926844,"(24.0, 37.5]",Q2
36123,2020-05-09,24841,35,1,21,27,415,0.2857142857142857,1.1501722382926844,"(24.0, 37.5]",Q2
36123,2020-05-10,24841,35,0,21,15,430,0.2857142857142857,1.1501722382926844,"(24.0, 37.5]",Q2
36123,2020-05-11,24841,35,0,21,15,445,0.2857142857142857,1.1501722382926844,"(24.0, 37.5]",Q2
36123,2020-05-12,24841,35,1,22,23,468,0.42857142857142855,1.7252583574390266,"(24.0, 37.5]",Q2
36123,2020-05-13,24841,35,0,22,51,519,0.42857142857142855,1.7252583574390266,"(24.0, 37.5]",Q2
36123,2020-05-14,24841,35,0,22,16,535,0.2857142857142857,1.1501722382926844,"(24.0, 37.5]",Q2
36123,2020-05-15,24841,35,0,22,15,550,0.2857142857142857,1.1501722382926844,"(24.0, 37.5]",Q2
36123,2020-05-16,24841,35,1,23,14,564,0.2857142857142857,1.1501722382926844,"(24.0, 37.5]",Q2
36123,2020-05-17,24841,35,2,25,22,586,0.5714285714285714,2.300344476585369,"(24.0, 37.5]",Q2
36123,2020-05-18,24841,35,1,26,25,611,0.7142857142857143,2.875430595731711,"(24.0, 37.5]",Q2
36123,2020-05-19,24841,35,8,34,67,678,1.7142857142857142,6.901033429756106,"(24.0, 37.5]",Q2
36123,2020-05-20,24841,35,0,34,62,740,1.7142857142857142,6.901033429756106,"(24.0, 37.5]",Q2
36123,2020-05-21,24841,35,0,34,107,847,1.7142857142857142,6.901033429756106,"(24.0, 37.5]",Q2
36123,2020-05-22,24841,35,3,37,22,869,2.142857142857143,8.626291787195132,"(24.0, 37.5]",Q2
36123,2020-05-23,24841,35,0,37,58,927,2.0,8.051205668048791,"(24.0, 37.5]",Q2
36123,2020-05-24,24841,35,0,37,28,955,1.7142857142857142,6.901033429756106,"(24.0, 37.5]",Q2
36123,2020-05-25,24841,35,0,37,67,1022,1.5714285714285714,6.325947310609763,"(24.0, 37.5]",Q2
36123,2020-05-26,24841,35,2,39,28,1050,0.7142857142857143,2.875430595731711,"(24.0, 37.5]",Q2
36123,2020-05-27,24841,35,0,39,50,1100,0.7142857142857143,2.875430595731711,"(24.0, 37.5]",Q2
36123,2020-05-28,24841,35,0,39,130,1230,0.7142857142857143,2.875430595731711,"(24.0, 37.5]",Q2
36123,2020-05-29,24841,35,0,39,31,1261,0.2857142857142857,1.1501722382926844,"(24.0, 37.5]",Q2
36123,2020-05-30,24841,35,0,39,87,1348,0.2857142857142857,1.1501722382926844,"(24.0, 37.5]",Q2
36123,2020-05-31,24841,35,0,39,77,1425,0.2857142857142857,1.1501722382926844,"(24.0, 37.5]",Q2
36123,2020-06-01,24841,35,0,39,48,1473,0.2857142857142857,1.1501722382926844,"(24.0, 37.5]",Q2
36123,2020-06-02,24841,35,0,39,108,1581,0.0,0.0,"(24.0, 37.5]",Q2
36123,2020-06-03,24841,35,0,39,78,1659,0.0,0.0,"(24.0, 37.5]",Q2
36123,2020-06-04,24841,35,0,39,113,1772,0.0,0.0,"(24.0, 37.5]",Q2
36123,2020-06-05,24841,35,0,39,109,1881,0.0,0.0,"(24.0, 37.5]",Q2
36123,2020-06-06,24841,35,0,39,73,1954,0.0,0.0,"(24.0, 37.5]",Q2
36123,2020-06-07,24841,35,0,39,110,2064,0.0,0.0,"(24.0, 37.5]",Q2
